コード,ランキング,都道府県,市区町村,人口,男,女
011002,4,北海道,札幌市,1956928,915082,1041846
012025,110,北海道,函館市,240218,109343,130875
012033,267,北海道,小樽市,106507,48187,58320
012041,76,北海道,旭川市,320436,148621,171815
012050,356,北海道,室蘭市,76519,36851,39668
012068,171,北海道,釧路市,157519,74072,83447
012076,165,北海道,帯広市,162460,77538,84922
012084,255,北海道,北見市,111740,53252,58488
012092,1361,北海道,夕張市,6411,3032,3379
012106,363,北海道,岩見沢市,75522,35270,40252
012114,706,北海道,網走市,32846,16129,16717
012122,946,北海道,留萌市,18695,9042,9653
012131,161,北海道,苫小牧市,166846,81829,85017
012149,739,北海道,稚内市,30946,15308,15638
012157,937,北海道,美唄市,18976,9021,9955
012165,1145,北海道,芦別市,11571,5331,6240
012173,227,北海道,江別市,118686,56361,62325
012181,1251,北海道,赤平市,8741,3974,4767
012190,913,北海道,紋別市,20260,9519,10741
012203,986,北海道,士別市,16869,8060,8809
012211,834,北海道,名寄市,25376,12348,13028
012220,1301,北海道,三笠市,7465,3423,4042
012238,870,北海道,根室市,23006,11008,11998
012246,287,北海道,千歳市,97999,49794,48205
012254,653,北海道,滝川市,37309,17670,19639
012262,1020,北海道,砂川市,15520,7207,8313
012271,1599,北海道,歌志内市,2668,1274,1394
012289,944,北海道,深川市,18764,8725,10039
012297,917,北海道,富良野市,19949,9442,10507
012301,578,北海道,登別市,44451,21260,23191
012319,396,北海道,恵庭市,70354,34217,36137
012335,725,北海道,伊達市,31822,14788,17034
012343,470,北海道,北広島市,56903,27211,29692
012351,466,北海道,石狩市,57645,27890,29755
012360,590,北海道,北斗市,43660,20557,23103
013030,1030,北海道,石狩郡当別町,15286,7479,7807
013048,1586,北海道,石狩郡新篠津村,2808,1350,1458
013315,1390,北海道,松前郡松前町,6030,2855,3175
013323,1544,北海道,松前郡福島町,3467,1623,1844
013331,1516,北海道,上磯郡知内町,3898,1912,1986
013340,1527,北海道,上磯郡木古内町,3644,1703,1941
013374,797,北海道,亀田郡七飯町,27544,12759,14785
013439,1534,北海道,茅部郡鹿部町,3570,1689,1881
013455,1081,北海道,茅部郡森町,13865,6471,7394
013463,1046,北海道,二海郡八雲町,14779,7336,7443
013471,1455,北海道,山越郡長万部町,4817,2278,2539
013617,1338,北海道,檜山郡江差町,6820,3280,3540
013625,1493,北海道,檜山郡上ノ国町,4254,1982,2272
013633,1545,北海道,檜山郡厚沢部町,3405,1628,1777
013641,1552,北海道,爾志郡乙部町,3249,1480,1769
013676,1630,北海道,奥尻郡奥尻町,2269,1198,1071
013706,1472,北海道,瀬棚郡今金町,4623,2230,2393
013714,1331,北海道,久遠郡せたな町,6948,3285,3663
013919,1689,北海道,島牧郡島牧村,1286,633,653
013927,1597,北海道,寿都郡寿都町,2694,1335,1359
013935,1606,北海道,寿都郡黒松内町,2573,1222,1351
013943,1481,北海道,磯谷郡蘭越町,4496,2188,2308
013951,1422,北海道,虻田郡ニセコ町,5481,2840,2641
013960,1652,北海道,虻田郡真狩村,1952,995,957
013978,1647,北海道,虻田郡留寿都村,2036,1050,986
013986,1651,北海道,虻田郡喜茂別町,1957,975,982
013994,1587,北海道,虻田郡京極町,2800,1361,1439
014001,997,北海道,虻田郡倶知安町,16505,8600,7905
014010,1425,北海道,岩内郡共和町,5430,2754,2676
014028,1158,北海道,岩内郡岩内町,11094,5241,5853
014036,1677,北海道,古宇郡泊村,1464,717,747
014044,1718,北海道,古宇郡神恵内村,757,368,389
014052,1658,北海道,積丹郡積丹町,1770,821,949
014061,1600,北海道,古平郡古平町,2656,1261,1395
014079,1564,北海道,余市郡仁木町,3040,1484,1556
014087,981,北海道,余市郡余市町,17222,7994,9228
014095,1685,北海道,余市郡赤井川村,1353,731,622
014231,1289,北海道,空知郡南幌町,7785,3744,4041
014249,1451,北海道,空知郡奈井江町,4819,2277,2542
014257,1616,北海道,空知郡上砂川町,2459,1137,1322
014273,1468,北海道,夕張郡由仁町,4662,2231,2431
014281,1207,北海道,夕張郡長沼町,10057,4826,5231
014290,1171,北海道,夕張郡栗山町,10905,5091,5814
014303,1583,北海道,樺戸郡月形町,2821,1455,1366
014311,1667,北海道,樺戸郡浦臼町,1605,776,829
014320,1369,北海道,樺戸郡新十津川町,6312,2946,3366
014338,1602,北海道,雨竜郡妹背牛町,2635,1251,1384
014346,1635,北海道,雨竜郡秩父別町,2229,1046,1183
014362,1644,北海道,雨竜郡雨竜町,2109,1032,1077
014371,1664,北海道,雨竜郡北竜町,1637,776,861
014389,1581,北海道,雨竜郡沼田町,2840,1365,1475
014524,1348,北海道,上川郡鷹栖町,6585,3148,3437
014532,1213,北海道,上川郡東神楽町,9862,4673,5189
014541,1383,北海道,上川郡当麻町,6136,2848,3288
014559,1543,北海道,上川郡比布町,3471,1646,1825
014567,1611,北海道,上川郡愛別町,2480,1176,1304
014575,1557,北海道,上川郡上川町,3150,1495,1655
014583,1254,北海道,上川郡東川町,8576,3988,4588
014591,1226,北海道,上川郡美瑛町,9432,4424,5008
014605,1210,北海道,空知郡上富良野町,10004,5096,4908
014613,1476,北海道,空知郡中富良野町,4579,2152,2427
014621,1627,北海道,空知郡南富良野町,2288,1167,1121
014630,1669,北海道,勇払郡占冠村,1591,840,751
014648,1577,北海道,上川郡和寒町,2903,1392,1511
014656,1585,北海道,上川郡剣淵町,2811,1385,1426
014681,1575,北海道,上川郡下川町,2935,1405,1530
014699,1521,北海道,中川郡美深町,3789,1841,1948
014702,1725,北海道,中川郡音威子府村,636,343,293
014711,1687,北海道,中川郡中川町,1304,672,632
014729,1692,北海道,雨竜郡幌加内町,1261,625,636
014818,1525,北海道,増毛郡増毛町,3725,1697,2028
014826,1589,北海道,留萌郡小平町,2781,1327,1454
014834,1593,北海道,苫前郡苫前町,2747,1344,1403
014842,1384,北海道,苫前郡羽幌町,6135,2977,3158
014851,1704,北海道,苫前郡初山別村,1046,510,536
014869,1625,北海道,天塩郡遠別町,2335,1132,1203
014877,1595,北海道,天塩郡天塩町,2732,1386,1346
015113,1601,北海道,宗谷郡猿払村,2648,1274,1374
015121,1549,北海道,枝幸郡浜頓別町,3299,1608,1691
015130,1674,北海道,枝幸郡中頓別町,1504,754,750
015148,1310,北海道,枝幸郡枝幸町,7300,3526,3774
015164,1530,北海道,天塩郡豊富町,3583,1832,1751
015172,1633,北海道,礼文郡礼文町,2253,1153,1100
015181,1654,北海道,利尻郡利尻町,1865,931,934
015199,1637,北海道,利尻郡利尻富士町,2194,1069,1125
015202,1645,北海道,天塩郡幌延町,2102,1094,1008
015431,967,北海道,網走郡美幌町,17813,8700,9113
015440,1503,北海道,網走郡津別町,4100,2010,2090
015458,1183,北海道,斜里郡斜里町,10694,5275,5419
015466,1526,北海道,斜里郡清里町,3715,1828,1887
015474,1484,北海道,斜里郡小清水町,4415,2114,2301
015491,1479,北海道,常呂郡訓子府町,4533,2192,2341
015504,1603,北海道,常呂郡置戸町,2608,1205,1403
015521,1464,北海道,常呂郡佐呂間町,4688,2198,2490
015555,959,北海道,紋別郡遠軽町,18068,8816,9252
015598,1284,北海道,紋別郡湧別町,7983,3833,4150
015601,1626,北海道,紋別郡滝上町,2293,1124,1169
015610,1535,北海道,紋別郡興部町,3564,1761,1803
015628,1707,北海道,紋別郡西興部村,981,509,472
015636,1504,北海道,紋別郡雄武町,4093,1975,2118
015644,1345,北海道,網走郡大空町,6626,3234,3392
015717,1536,北海道,虻田郡豊浦町,3558,1714,1844
015750,1621,北海道,有珠郡壮瞥町,2391,1160,1231
015784,1023,北海道,白老郡白老町,15451,7357,8094
015814,1490,北海道,勇払郡厚真町,4306,2182,2124
015849,1277,北海道,虻田郡洞爺湖町,8068,3720,4348
015857,1308,北海道,勇払郡安平町,7311,3648,3663
015865,1307,北海道,勇払郡むかわ町,7323,3598,3725
016012,1157,北海道,沙流郡日高町,11107,5726,5381
016021,1478,北海道,沙流郡平取町,4539,2249,2290
016047,1439,北海道,新冠郡新冠町,5137,2560,2577
016071,1148,北海道,浦河郡浦河町,11453,5778,5675
016080,1515,北海道,様似郡様似町,3901,1886,2015
016098,1500,北海道,幌泉郡えりも町,4178,2120,2058
016101,910,北海道,日高郡新ひだか町,20591,10144,10447
016314,598,北海道,河東郡音更町,42971,20388,22583
016322,1407,北海道,河東郡士幌町,5829,2871,2958
016331,1457,北海道,河東郡上士幌町,4784,2371,2413
016349,1442,北海道,河東郡鹿追町,5061,2475,2586
016357,1419,北海道,上川郡新得町,5531,2774,2757
016365,1243,北海道,上川郡清水町,8907,4431,4476
016373,962,北海道,河西郡芽室町,17955,8574,9381
016381,1518,北海道,河西郡中札内村,3886,1883,2003
016390,1559,北海道,河西郡更別村,3129,1535,1594
016411,1426,北海道,広尾郡大樹町,5337,2695,2642
016420,1392,北海道,広尾郡広尾町,6009,2904,3105
016438,830,北海道,中川郡幕別町,25617,12178,13439
016446,1391,北海道,中川郡池田町,6012,2839,3173
016454,1574,北海道,中川郡豊頃町,2937,1432,1505
016462,1376,北海道,中川郡本別町,6190,3034,3156
016471,1379,北海道,足寄郡足寄町,6172,3043,3129
016489,1640,北海道,足寄郡陸別町,2159,1086,1073
016497,1497,北海道,十勝郡浦幌町,4195,2061,2134
016616,948,北海道,釧路郡釧路町,18642,8859,9783
016624,1265,北海道,厚岸郡厚岸町,8395,3985,4410
016632,1427,北海道,厚岸郡浜中町,5333,2615,2718
016641,1325,北海道,川上郡標茶町,6999,3418,3581
016659,1344,北海道,川上郡弟子屈町,6640,3194,3446
016675,1615,北海道,阿寒郡鶴居村,2466,1238,1228
016683,1319,北海道,白糠郡白糠町,7127,3334,3793
016918,1067,北海道,野付郡別海町,14210,7219,6991
016926,879,北海道,標津郡中標津町,22440,11085,11355
016934,1446,北海道,標津郡標津町,4849,2356,2493
016942,1486,北海道,目梨郡羅臼町,4367,2184,2183
016951,1748,北海道,色丹郡色丹村,0,0,0
016969,1747,北海道,国後郡泊村,0,0,0
016977,1746,北海道,国後郡留夜別村,0,0,0
016985,1745,北海道,択捉郡留別村,0,0,0
016993,1744,北海道,紗那郡紗那村,0,0,0
017001,1743,北海道,蘂取郡蘂取村,0,0,0
022012,95,青森県,青森市,267520,124900,142620
022021,166,青森県,弘前市,161958,74866,87092
022039,125,青森県,八戸市,218182,104588,113594
022047,738,青森県,黒石市,31003,14513,16490
022055,513,青森県,五所川原市,50624,23220,27404
022063,460,青森県,十和田市,58328,27936,30392
022071,646,青森県,三沢市,37899,18870,19029
022080,501,青森県,むつ市,52744,25748,26996
022098,765,青森県,つがる市,29472,13838,15634
022101,760,青森県,平川市,29713,14007,15706
023019,1212,青森県,東津軽郡平内町,9948,4744,5204
023035,1638,青森県,東津軽郡今別町,2193,1055,1138
023043,1610,青森県,東津軽郡蓬田村,2495,1207,1288
023078,1438,青森県,東津軽郡外ヶ浜町,5152,2460,2692
023213,1250,青森県,西津軽郡鰺ヶ沢町,8758,4110,4648
023230,1322,青森県,西津軽郡深浦町,7038,3338,3700
023434,1693,青森県,中津軽郡西目屋村,1242,577,665
023612,1057,青森県,南津軽郡藤崎町,14422,6776,7646
023621,1260,青森県,南津軽郡大鰐町,8470,3904,4566
023671,1305,青森県,南津軽郡田舎館村,7352,3489,3863
023817,1126,青森県,北津軽郡板柳町,12445,5735,6710
023841,1140,青森県,北津軽郡鶴田町,11756,5491,6265
023876,1220,青森県,北津軽郡中泊町,9645,4554,5091
024015,1132,青森県,上北郡野辺地町,12027,5624,6403
024023,1063,青森県,上北郡七戸町,14320,6860,7460
024058,1181,青森県,上北郡六戸町,10714,5289,5425
024066,1499,青森県,上北郡横浜町,4181,2093,2088
024082,998,青森県,上北郡東北町,16354,7938,8416
024112,1217,青森県,上北郡六ヶ所村,9736,5333,4403
024121,836,青森県,上北郡おいらせ町,25148,12160,12988
024236,1461,青森県,下北郡大間町,4771,2436,2335
024244,1410,青森県,下北郡東通村,5738,2986,2752
024252,1666,青森県,下北郡風間浦村,1618,782,836
024261,1661,青森県,下北郡佐井村,1711,862,849
024414,1240,青森県,三戸郡三戸町,9022,4350,4672
024422,1017,青森県,三戸郡五戸町,15653,7571,8082
024431,1454,青森県,三戸郡田子町,4817,2320,2497
024457,995,青森県,三戸郡南部町,16543,7845,8698
024465,1119,青森県,三戸郡階上町,12737,6414,6323
024503,1642,青森県,三戸郡新郷村,2129,1056,1073
032018,89,岩手県,盛岡市,280286,132316,147970
032026,558,岩手県,宮古市,46866,22500,24366
032034,707,岩手県,大船渡市,32845,15700,17145
032051,308,岩手県,花巻市,91094,43661,47433
032069,305,岩手県,北上市,91547,45934,45613
032077,722,岩手県,久慈市,32000,15460,16540
032085,846,岩手県,遠野市,24528,11829,12699
032093,262,岩手県,一関市,107555,52436,55119
032107,970,岩手県,陸前高田市,17647,8499,9148
032115,757,岩手県,釜石市,29902,14289,15613
032131,842,岩手県,二戸市,24655,11692,12963
032140,861,岩手県,八幡平市,23541,11368,12173
032158,259,岩手県,奥州市,109747,53553,56194
032166,484,岩手県,滝沢市,54933,26997,27936
033014,1028,岩手県,岩手郡雫石町,15301,7396,7905
033022,1424,岩手県,岩手郡葛巻町,5433,2690,2743
033031,1137,岩手県,岩手郡岩手町,11841,5805,6036
033219,702,岩手県,紫波郡紫波町,32904,15861,17043
033227,814,岩手県,紫波郡矢巾町,26341,12598,13743
033669,1448,岩手県,和賀郡西和賀町,4840,2281,2559
033812,1034,岩手県,胆沢郡金ケ崎町,15183,7803,7380
034029,1335,岩手県,西磐井郡平泉町,6859,3321,3538
034410,1453,岩手県,気仙郡住田町,4817,2384,2433
034614,1182,岩手県,上閉伊郡大槌町,10709,5133,5576
034827,1066,岩手県,下閉伊郡山田町,14240,6981,7259
034835,1281,岩手県,下閉伊郡岩泉町,8038,3972,4066
034843,1569,岩手県,下閉伊郡田野畑村,2977,1499,1478
034851,1623,岩手県,下閉伊郡普代村,2362,1187,1175
035017,1271,岩手県,九戸郡軽米町,8134,3995,4139
035033,1514,岩手県,九戸郡野田村,3975,1943,2032
035068,1434,岩手県,九戸郡九戸村,5238,2501,2737
035076,1039,岩手県,九戸郡洋野町,15051,7300,7751
035246,1165,岩手県,二戸郡一戸町,10960,5310,5650
041009,11,宮城県,仙台市,1066362,515655,550707
042021,206,宮城県,石巻市,134711,65406,69305
042030,507,宮城県,塩竈市,52058,24983,27075
042056,465,宮城県,気仙沼市,57652,27800,29852
042064,735,宮城県,白石市,31229,15409,15820
042072,342,宮城県,名取市,79720,39197,40523
042081,804,宮城県,角田市,26917,13417,13500
042099,434,宮城県,多賀城市,62061,30795,31266
042111,592,宮城県,岩沼市,43448,21475,21973
042129,377,宮城県,登米市,73338,35987,37351
042137,435,宮城県,栗原市,61910,30165,31745
042145,639,宮城県,東松島市,38343,18777,19566
042153,222,宮城県,大崎市,123776,60966,62810
042161,504,宮城県,富谷市,52418,25780,26638
043010,1159,宮城県,刈田郡蔵王町,11074,5441,5633
043028,1696,宮城県,刈田郡七ヶ宿町,1225,605,620
043214,862,宮城県,柴田郡大河原町,23531,11522,12009
043222,1206,宮城県,柴田郡村田町,10061,5048,5013
043231,656,宮城県,柴田郡柴田町,36800,18338,18462
043249,1273,宮城県,柴田郡川崎町,8116,4028,4088
043419,1136,宮城県,伊具郡丸森町,11911,6013,5898
043613,699,宮城県,亘理郡亘理町,33077,16272,16805
043621,1146,宮城県,亘理郡山元町,11562,5723,5839
044016,1102,宮城県,宮城郡松島町,13085,6333,6752
044041,968,宮城県,宮城郡七ヶ浜町,17795,8870,8925
044067,663,宮城県,宮城郡利府町,35888,17708,18180
044211,788,宮城県,黒川郡大和町,27964,14458,13506
044229,1298,宮城県,黒川郡大郷町,7584,3784,3800
044245,1415,宮城県,黒川郡大衡村,5569,2804,2765
044440,1372,宮城県,加美郡色麻町,6265,3034,3231
044458,898,宮城県,加美郡加美町,21427,10586,10841
045012,1049,宮城県,遠田郡涌谷町,14628,7207,7421
045055,866,宮城県,遠田郡美里町,23195,11331,11864
045811,1401,宮城県,牡鹿郡女川町,5918,2913,3005
046060,1138,宮城県,本吉郡南三陸町,11771,5794,5977
052019,85,秋田県,秋田市,297316,140206,157110
052027,541,秋田県,能代市,48334,22450,25884
052035,333,秋田県,横手市,82454,39160,43294
052043,412,秋田県,大館市,66807,31551,35256
052060,853,秋田県,男鹿市,24014,11442,12572
052078,622,秋田県,湯沢市,40531,19549,20982
052094,794,秋田県,鹿角市,27714,13169,14545
052108,388,秋田県,由利本荘市,71723,34625,37098
052116,730,秋田県,潟上市,31624,15001,16623
052124,367,秋田県,大仙市,75207,35423,39784
052132,776,秋田県,北秋田市,28536,13436,15100
052141,878,秋田県,にかほ市,22463,10790,11673
052159,864,秋田県,仙北市,23443,10884,12559
053031,1477,秋田県,鹿角郡小坂町,4550,2123,2427
053279,1650,秋田県,北秋田郡上小阿仁村,1958,935,1023
053465,1584,秋田県,山本郡藤里町,2819,1354,1465
053481,1050,秋田県,山本郡三種町,14609,6777,7832
053490,1370,秋田県,山本郡八峰町,6301,2961,3340
053619,1280,秋田県,南秋田郡五城目町,8060,3771,4289
053635,1430,秋田県,南秋田郡八郎潟町,5277,2412,2865
053660,1489,秋田県,南秋田郡井川町,4310,2046,2264
053686,1570,秋田県,南秋田郡大潟村,2976,1490,1486
054348,966,秋田県,仙北郡美郷町,17831,8455,9376
054631,1093,秋田県,雄勝郡羽後町,13367,6505,6862
054640,1620,秋田県,雄勝郡東成瀬村,2396,1252,1144
062014,112,山形県,山形市,238293,114225,124068
062022,361,山形県,米沢市,75838,37245,38593
062031,226,山形県,鶴岡市,118692,57067,61625
062049,294,山形県,酒田市,95789,45970,49819
062057,705,山形県,新庄市,32860,15739,17121
062065,627,山形県,寒河江市,39745,19458,20287
062073,785,山形県,上山市,28084,13510,14574
062081,889,山形県,村山市,21742,10673,11069
062090,840,山形県,長井市,24851,12181,12670
062103,445,山形県,天童市,60627,29668,30959
062111,547,山形県,東根市,47830,23597,24233
062120,1075,山形県,尾花沢市,13996,6930,7066
062138,766,山形県,南陽市,29465,14272,15193
063011,1090,山形県,東村山郡山辺町,13570,6633,6937
063029,1184,山形県,東村山郡中山町,10590,5182,5408
063215,984,山形県,西村山郡河北町,17000,8344,8656
063223,1471,山形県,西村山郡西川町,4655,2261,2394
063231,1393,山形県,西村山郡朝日町,5999,2983,3016
063240,1311,山形県,西村山郡大江町,7284,3662,3622
063410,1385,山形県,北村山郡大石田町,6124,3043,3081
063614,1447,山形県,最上郡金山町,4848,2403,2445
063622,1296,山形県,最上郡最上町,7607,3747,3860
063631,1460,山形県,最上郡舟形町,4771,2336,2435
063649,1343,山形県,最上郡真室川町,6651,3201,3450
063657,1582,山形県,最上郡大蔵村,2830,1411,1419
063665,1522,山形県,最上郡鮭川村,3767,1821,1946
063673,1512,山形県,最上郡戸沢村,3998,1902,2096
063819,890,山形県,東置賜郡高畠町,21681,10628,11053
063827,1087,山形県,東置賜郡川西町,13698,6757,6941
064017,1340,山形県,西置賜郡小国町,6737,3396,3341
064025,1123,山形県,西置賜郡白鷹町,12507,6186,6321
064033,1365,山形県,西置賜郡飯豊町,6398,3169,3229
064262,1320,山形県,東田川郡三川町,7062,3456,3606
064289,926,山形県,東田川郡庄内町,19453,9421,10032
064611,1125,山形県,飽海郡遊佐町,12467,5958,6509
072010,94,福島県,福島市,267924,130065,137859
072028,251,福島県,会津若松市,112445,54060,58385
072036,79,福島県,郡山市,315155,154613,160542
072044,83,福島県,いわき市,306714,150847,155867
072052,464,福島県,白河市,57869,28906,28963
072079,375,福島県,須賀川市,73828,36437,37391
072087,580,福島県,喜多方市,44344,21497,22847
072095,708,福島県,相馬市,32842,16333,16509
072109,509,福島県,二本松市,51263,25401,25862
072117,688,福島県,田村市,33600,16626,16974
072125,474,福島県,南相馬市,56618,28257,28361
072133,473,福島県,伊達市,56768,27739,29029
072141,759,福島県,本宮市,29852,14780,15072
073016,1161,福島県,伊達郡桑折町,11050,5367,5683
073032,1269,福島県,伊達郡国見町,8203,3957,4246
073083,1142,福島県,伊達郡川俣町,11687,5829,5858
073229,1249,福島県,安達郡大玉村,8784,4361,4423
073423,1127,福島県,岩瀬郡鏡石町,12436,6142,6294
073440,1431,福島県,岩瀬郡天栄村,5245,2649,2596
073628,1443,福島県,南会津郡下郷町,4986,2483,2503
073644,1730,福島県,南会津郡檜枝岐村,503,263,240
073679,1520,福島県,南会津郡只見町,3828,1890,1938
073687,1085,福島県,南会津郡南会津町,13733,6758,6975
074021,1619,福島県,耶麻郡北塩原村,2427,1228,1199
074055,1416,福島県,耶麻郡西会津町,5560,2717,2843
074071,1553,福島県,耶麻郡磐梯町,3230,1606,1624
074080,1113,福島県,耶麻郡猪苗代町,12836,6296,6540
074217,1054,福島県,河沼郡会津坂下町,14552,7069,7483
074225,1563,福島県,河沼郡湯川村,3050,1481,1569
074233,1573,福島県,河沼郡柳津町,2938,1459,1479
074446,1684,福島県,大沼郡三島町,1380,697,683
074454,1656,福島県,大沼郡金山町,1781,880,901
074462,1700,福島県,大沼郡昭和村,1120,545,575
074471,950,福島県,大沼郡会津美里町,18526,8972,9554
074616,911,福島県,西白河郡西郷村,20494,10407,10087
074641,1382,福島県,西白河郡泉崎村,6140,3069,3071
074659,1450,福島県,西白河郡中島村,4822,2358,2464
074667,985,福島県,西白河郡矢吹町,16944,8426,8518
074811,1104,福島県,東白川郡棚倉町,13011,6422,6589
074829,1432,福島県,東白川郡矢祭町,5241,2579,2662
074837,1285,福島県,東白川郡塙町,7979,3961,4018
074845,1571,福島県,東白川郡鮫川村,2975,1518,1457
075019,1080,福島県,石川郡石川町,13884,6938,6946
075027,1375,福島県,石川郡玉川村,6191,3095,3096
075035,1420,福島県,石川郡平田村,5512,2790,2722
075043,1404,福島県,石川郡浅川町,5896,2960,2936
075051,1470,福島県,石川郡古殿町,4655,2304,2351
075213,1001,福島県,田村郡三春町,16312,8129,8183
075221,1238,福島県,田村郡小野町,9092,4547,4545
075418,1473,福島県,双葉郡広野町,4608,2434,2174
075426,1357,福島県,双葉郡楢葉町,6480,3385,3095
075434,1147,福島県,双葉郡富岡町,11516,5987,5529
075442,1628,福島県,双葉郡川内村,2285,1154,1131
075451,1211,福島県,双葉郡大熊町,9955,4990,4965
075469,1423,福島県,双葉郡双葉町,5436,2636,2800
075477,1035,福島県,双葉郡浪江町,15174,7530,7644
075485,1691,福島県,双葉郡葛尾村,1273,657,616
075612,1299,福島県,相馬郡新地町,7581,3807,3774
075647,1465,福島県,相馬郡飯舘村,4686,2357,2329
082015,92,茨城県,水戸市,268843,131737,137106
082023,159,茨城県,日立市,167198,83656,83542
082031,193,茨城県,土浦市,141613,71072,70541
082040,198,茨城県,古河市,140499,71050,69449
082058,392,茨城県,石岡市,70981,35320,35661
082074,518,茨城県,結城市,49936,25350,24586
082082,364,茨城県,龍ケ崎市,75509,37558,37951
082104,605,茨城県,下妻市,42272,21526,20746
082112,440,茨城県,常総市,61180,31004,30176
082121,550,茨城県,常陸太田市,47338,23323,24015
082147,816,茨城県,高萩市,26315,13109,13206
082155,619,茨城県,北茨城市,40757,20454,20303
082163,379,茨城県,笠間市,73183,36176,37007
082171,271,茨城県,取手市,106008,52250,53758
082198,327,茨城県,牛久市,84085,41486,42599
082201,103,茨城県,つくば市,255244,129878,125366
082210,173,茨城県,ひたちなか市,155762,78565,77197
082228,416,茨城県,鹿嶋市,65797,33694,32103
082236,810,茨城県,潮来市,26555,13229,13326
082244,394,茨城県,守谷市,70659,35367,35292
082252,635,茨城県,常陸大宮市,38664,19305,19359
082261,497,茨城県,那珂市,53501,26291,27210
082279,277,茨城県,筑西市,100670,50217,50453
082287,505,茨城県,坂東市,52346,27130,25216
082295,648,茨城県,稲敷市,37692,19066,18626
082309,623,茨城県,かすみがうら市,40369,20622,19747
082317,642,茨城県,桜川市,38250,19121,19129
082325,297,茨城県,神栖市,94295,48625,45670
082333,718,茨城県,行方市,32055,16218,15837
082341,555,茨城県,鉾田市,47018,24474,22544
082350,498,茨城県,つくばみらい市,53446,26844,26602
082368,536,茨城県,小美玉市,48797,24666,24131
083020,743,茨城県,東茨城郡茨城町,30784,15463,15321
083097,1014,茨城県,東茨城郡大洗町,15717,7808,7909
083101,958,茨城県,東茨城郡城里町,18079,9025,9054
083411,640,茨城県,那珂郡東海村,38297,19447,18850
083640,1042,茨城県,久慈郡大子町,14952,7411,7541
084425,1058,茨城県,稲敷郡美浦村,14365,7402,6963
084433,525,茨城県,稲敷郡阿見町,49489,24692,24797
084476,1286,茨城県,稲敷郡河内町,7953,3947,4006
085219,905,茨城県,結城郡八千代町,21090,11088,10002
085421,1278,茨城県,猿島郡五霞町,8063,4117,3946
085464,843,茨城県,猿島郡境町,24637,12646,11991
085642,1024,茨城県,北相馬郡利根町,15427,7621,7806
092011,34,栃木県,宇都宮市,515831,258149,257682
092029,196,栃木県,足利市,141021,69619,71402
092037,174,栃木県,栃木市,154371,77216,77155
092045,243,栃木県,佐野市,114146,56762,57384
092053,299,栃木県,鹿沼市,93807,46715,47092
092061,358,栃木県,日光市,76413,37377,39036
092088,160,栃木県,小山市,166975,84835,82140
092096,344,栃木県,真岡市,79002,40016,38986
092100,402,栃木県,大田原市,68873,34237,34636
092118,747,栃木県,矢板市,30577,15211,15366
092134,235,栃木県,那須塩原市,116133,57973,58160
092142,587,栃木県,さくら市,43802,22084,21718
092151,852,栃木県,那須烏山市,24035,12021,12014
092169,448,栃木県,下野市,59880,29761,30119
093017,737,栃木県,河内郡上三川町,31012,15978,15034
093424,892,栃木県,芳賀郡益子町,21616,10798,10818
093432,1141,栃木県,芳賀郡茂木町,11703,5834,5869
093441,1155,栃木県,芳賀郡市貝町,11277,5768,5509
093459,1021,栃木県,芳賀郡芳賀町,15505,7890,7615
093611,638,栃木県,下都賀郡壬生町,38359,18994,19365
093645,837,栃木県,下都賀郡野木町,25006,12508,12498
093840,1204,栃木県,塩谷郡塩谷町,10069,5026,5043
093866,773,栃木県,塩谷郡高根沢町,28803,15111,13692
094072,854,栃木県,那須郡那須町,24011,11967,12044
094111,1053,栃木県,那須郡那珂川町,14560,7376,7184
102016,75,群馬県,前橋市,329860,161386,168474
102024,63,群馬県,高崎市,367861,180725,187136
102032,275,群馬県,桐生市,102988,49728,53260
102041,127,群馬県,伊勢崎市,212237,106736,105501
102059,123,群馬県,太田市,222518,113878,108640
102067,579,群馬県,沼田市,44361,21705,22656
102075,372,群馬県,館林市,74084,37147,36937
102083,381,群馬県,渋川市,73068,35763,37305
102091,433,群馬県,藤岡市,62261,30528,31733
102105,567,群馬県,富岡市,45862,22696,23166
102113,487,群馬県,安中市,54643,26982,27661
102121,534,群馬県,みどり市,48921,24209,24712
103446,1048,群馬県,北群馬郡榛東村,14648,7507,7141
103454,876,群馬県,北群馬郡吉岡町,22563,11111,11452
103667,1705,群馬県,多野郡上野村,1039,528,511
103675,1670,群馬県,多野郡神流町,1564,749,815
103829,1368,群馬県,甘楽郡下仁田町,6316,3099,3217
103837,1673,群馬県,甘楽郡南牧村,1504,718,786
103845,1124,群馬県,甘楽郡甘楽町,12494,6200,6294
104213,1051,群馬県,吾妻郡中之条町,14576,7139,7437
104248,1433,群馬県,吾妻郡長野原町,5240,2647,2593
104256,1236,群馬県,吾妻郡嬬恋村,9117,4637,4480
104264,1389,群馬県,吾妻郡草津町,6031,3068,2963
104281,1551,群馬県,吾妻郡高山村,3268,1616,1652
104299,1128,群馬県,吾妻郡東吾妻町,12339,6080,6259
104434,1510,群馬県,利根郡片品村,3999,1991,2008
104442,1562,群馬県,利根郡川場村,3066,1465,1601
104485,1328,群馬県,利根郡昭和村,6979,3523,3456
104493,976,群馬県,利根郡みなかみ町,17293,8474,8819
104647,666,群馬県,佐波郡玉村町,35732,17773,17959
105210,1084,群馬県,邑楽郡板倉町,13747,6910,6837
105228,1176,群馬県,邑楽郡明和町,10836,5436,5400
105236,1168,群馬県,邑楽郡千代田町,10941,5559,5382
105244,612,群馬県,邑楽郡大泉町,41465,21638,19827
105252,824,群馬県,邑楽郡邑楽町,25811,13133,12678
111007,9,埼玉県,さいたま市,1345012,666409,678603
112011,67,埼玉県,川越市,352717,175614,177103
112020,136,埼玉県,熊谷市,192074,96157,95917
112038,27,埼玉県,川口市,606315,306883,299432
112062,347,埼玉県,行田市,78416,38840,39576
112071,461,埼玉県,秩父市,58223,28507,29716
112089,72,埼玉県,所沢市,343529,169449,174080
112097,346,埼玉県,飯能市,78472,39212,39260
112101,253,埼玉県,加須市,112163,56474,55689
112119,351,埼玉県,本庄市,77285,38645,38640
112127,307,埼玉県,東松山市,91094,45762,45332
112143,116,埼玉県,春日部市,230687,114099,116588
112151,183,埼玉県,狭山市,148872,74296,74576
112160,496,埼玉県,羽生市,53855,27071,26784
112178,228,埼玉県,鴻巣市,117582,58212,59370
112186,194,埼玉県,深谷市,141419,70624,70795
112194,118,埼玉県,上尾市,230167,113765,116402
112216,104,埼玉県,草加市,251219,126619,124600
112224,73,埼玉県,越谷市,343062,169773,173289
112232,362,埼玉県,蕨市,75646,38331,37315
112241,191,埼玉県,戸田市,142163,72126,70037
112259,189,埼玉県,入間市,144723,71436,73287
112275,187,埼玉県,朝霞市,144964,72997,71967
112283,359,埼玉県,志木市,76312,37759,38553
112291,324,埼玉県,和光市,84728,43484,41244
112305,163,埼玉県,新座市,166036,82635,83401
112313,371,埼玉県,桶川市,74448,36784,37664
112321,180,埼玉県,久喜市,150913,75084,75829
112330,420,埼玉県,北本市,65403,32259,33144
112348,301,埼玉県,八潮市,93065,48297,44768
112356,248,埼玉県,富士見市,113145,55530,57615
112372,192,埼玉県,三郷市,141942,71576,70366
112381,438,埼玉県,蓮田市,61337,30398,30939
112399,282,埼玉県,坂戸市,99527,49652,49875
112402,532,埼玉県,幸手市,49063,24668,24395
112411,397,埼玉県,鶴ヶ島市,70063,34732,35331
112429,489,埼玉県,日高市,54396,27032,27364
112437,382,埼玉県,吉川市,72678,36263,36415
112453,242,埼玉県,ふじみ野市,114363,56471,57892
112461,502,埼玉県,白岡市,52649,26141,26508
113018,573,埼玉県,北足立郡伊奈町,45045,22740,22305
113247,650,埼玉県,入間郡三芳町,37453,18588,18865
113263,712,埼玉県,入間郡毛呂山町,32365,16128,16237
113271,1175,埼玉県,入間郡越生町,10863,5414,5449
113417,923,埼玉県,比企郡滑川町,19745,10077,9668
113425,973,埼玉県,比企郡嵐山町,17516,8706,8810
113433,790,埼玉県,比企郡小川町,27886,13904,13982
113468,939,埼玉県,比企郡川島町,18874,9662,9212
113476,965,埼玉県,比企郡吉見町,17859,9016,8843
113484,1106,埼玉県,比企郡鳩山町,12967,6354,6613
113492,1187,埼玉県,比企郡ときがわ町,10414,5290,5124
113611,1292,埼玉県,秩父郡横瀬町,7748,3821,3927
113620,1239,埼玉県,秩父郡皆野町,9050,4530,4520
113638,1354,埼玉県,秩父郡長瀞町,6516,3207,3309
113654,1191,埼玉県,秩父郡小鹿野町,10316,5139,5177
113697,1612,埼玉県,秩父郡東秩父村,2473,1241,1232
113816,1178,埼玉県,児玉郡美里町,10819,5485,5334
113832,1110,埼玉県,児玉郡神川町,12888,6600,6288
113859,748,埼玉県,児玉郡上里町,30549,15269,15280
114081,720,埼玉県,大里郡寄居町,32041,15963,16078
114421,692,埼玉県,南埼玉郡宮代町,33371,16695,16676
114642,584,埼玉県,北葛飾郡杉戸町,44014,21995,22019
114651,782,埼玉県,北葛飾郡松伏町,28140,14199,13941
121002,12,千葉県,千葉市,978899,486126,492773
122025,481,千葉県,銚子市,55016,26845,28171
122033,37,千葉県,市川市,492895,249044,243851
122041,26,千葉県,船橋市,648331,322387,325944
122050,583,千葉県,館山市,44160,21381,22779
122068,203,千葉県,木更津市,136611,68971,67640
122076,36,千葉県,松戸市,498222,247223,250999
122084,176,千葉県,野田市,153815,77260,76555
122106,317,千葉県,茂原市,86613,42830,43783
122114,209,千葉県,成田市,132023,65981,66042
122122,157,千葉県,佐倉市,170406,83595,86811
122131,471,千葉県,東金市,56867,28445,28422
122157,426,千葉県,旭市,62747,31070,31677
122165,154,千葉県,習志野市,174963,86915,88048
122173,47,千葉県,柏市,435529,215150,220379
122181,1015,千葉県,勝浦市,15663,7816,7847
122190,93,千葉県,市原市,268517,138393,130124
122203,128,千葉県,流山市,210733,103794,106939
122211,130,千葉県,八千代市,205748,101471,104277
122220,211,千葉県,我孫子市,131286,64258,67028
122238,742,千葉県,鴨川市,30820,14750,16070
122246,260,千葉県,鎌ケ谷市,109557,53879,55678
122254,339,千葉県,君津市,80395,40889,39506
122262,615,千葉県,富津市,41119,20933,20186
122271,156,千葉県,浦安市,170671,82796,87875
122289,290,千葉県,四街道市,96479,48312,48167
122297,415,千葉県,袖ケ浦市,66022,33486,32536
122301,410,千葉県,八街市,67006,34403,32603
122319,256,千葉県,印西市,111274,55241,56033
122327,429,千葉県,白井市,62603,31207,31396
122335,521,千葉県,富里市,49668,25315,24353
122343,680,千葉県,南房総市,34815,16701,18114
122351,687,千葉県,匝瑳市,33797,16818,16979
122360,393,千葉県,香取市,70791,35243,35548
122378,540,千葉県,山武市,48369,24492,23877
122386,673,千葉県,いすみ市,35289,17409,17880
122394,543,千葉県,大網白里市,48180,23817,24363
123226,914,千葉県,印旛郡酒々井町,20207,10013,10194
123293,920,千葉県,印旛郡栄町,19842,9758,10084
123421,1413,千葉県,香取郡神崎町,5679,2884,2795
123471,1089,千葉県,香取郡多古町,13588,6952,6636
123498,1109,千葉県,香取郡東庄町,12906,6520,6386
124036,1061,千葉県,山武郡九十九里町,14333,7134,7199
124095,1339,千葉県,山武郡芝山町,6776,3450,3326
124109,880,千葉県,山武郡横芝光町,22378,11081,11297
124214,1129,千葉県,長生郡一宮町,12284,6072,6212
124222,1346,千葉県,長生郡睦沢町,6614,3253,3361
124231,1091,千葉県,長生郡長生村,13515,6691,6824
124249,1185,千葉県,長生郡白子町,10565,5316,5249
124265,1367,千葉県,長生郡長柄町,6316,3193,3123
124273,1315,千葉県,長生郡長南町,7243,3608,3635
124419,1270,千葉県,夷隅郡大多喜町,8164,4028,4136
124435,1324,千葉県,夷隅郡御宿町,7000,3358,3642
124630,1336,千葉県,安房郡鋸南町,6849,3326,3523
131016,404,東京都,千代田区,68755,34412,34343
131024,152,東京都,中央区,176835,84212,92623
131032,96,東京都,港区,266306,125353,140953
131041,69,東京都,新宿区,349226,175428,173798
131059,115,東京都,文京区,232177,110561,121616
131067,126,東京都,台東区,212388,108097,104291
131075,88,東京都,墨田区,284555,140148,144407
131083,32,東京都,江東区,539108,264566,274542
131091,51,東京都,品川区,408280,199866,208414
131105,90,東京都,目黒区,279520,131816,147704
131113,19,東京都,大田区,733634,364637,368997
131121,14,東京都,世田谷区,918141,434591,483550
131130,117,東京都,渋谷区,230609,110568,120041
131148,74,東京都,中野区,337377,170371,167006
131156,30,東京都,杉並区,572843,275440,297403
131164,86,東京都,豊島区,291650,146383,145267
131172,65,東京都,北区,357701,177688,180013
131181,124,東京都,荒川区,219268,108991,110277
131199,29,東京都,板橋区,572927,280059,292868
131202,18,東京都,練馬区,741540,358739,382801
131211,23,東京都,足立区,693223,346947,346276
131229,42,東京都,葛飾区,467000,232534,234466
131237,24,東京都,江戸川区,689961,347127,342834
132012,31,東京都,八王子市,560692,280146,280546
132021,146,東京都,立川市,185825,91979,93846
132039,184,東京都,武蔵野市,147809,70765,77044
132047,138,東京都,三鷹市,189959,92506,97453
132055,212,東京都,青梅市,129468,65036,64432
132063,98,東京都,府中市,260078,130030,130048
132071,241,東京都,昭島市,114516,56910,57606
132080,111,東京都,調布市,238774,116031,122743
132098,48,東京都,町田市,430380,210105,220275
132101,220,東京都,小金井市,124614,61291,63323
132110,133,東京都,小平市,196913,96365,100548
132128,143,東京都,日野市,187494,93731,93763
132136,179,東京都,東村山市,151751,73834,77917
132144,213,東京都,国分寺市,128762,63157,65605
132152,360,東京都,国立市,75889,36793,39096
132187,476,東京都,福生市,56512,28369,28143
132195,337,東京都,狛江市,82102,39623,42479
132209,322,東京都,東大和市,85085,41786,43299
132217,368,東京都,清瀬市,74596,35904,38692
132225,233,東京都,東久留米市,116512,56487,60025
132233,391,東京都,武蔵村山市,71018,35225,35793
132241,185,東京都,多摩市,147776,72350,75426
132250,300,東京都,稲城市,93781,46910,46871
132276,488,東京都,羽村市,54416,27558,26858
132284,343,東京都,あきる野市,79513,39584,39929
132292,129,東京都,西東京市,205899,99968,105931
133035,717,東京都,西多摩郡瑞穂町,32062,16278,15784
133051,1002,東京都,西多摩郡日の出町,16300,8036,8264
133078,1648,東京都,西多摩郡檜原村,1986,987,999
133086,1474,東京都,西多摩郡奥多摩町,4603,2287,2316
133604,857,東京都,島しょ,23793,12353,11440
133612,1327,東京都,大島町,6982,3635,3347
133621,1739,東京都,利島村,314,170,144
133639,1617,東京都,新島村,2453,1195,1258
133647,1657,東京都,神津島村,1775,911,864
133817,1632,東京都,三宅村,2254,1247,1007
133825,1741,東京都,御蔵島村,291,157,134
134015,1329,東京都,八丈町,6968,3496,3472
134023,1742,東京都,青ヶ島村,156,88,68
134210,1604,東京都,小笠原村,2600,1454,1146
141003,1,神奈川県,横浜市,3752969,1857671,1895298
141305,6,神奈川県,川崎市,1529136,772767,756369
141500,21,神奈川県,相模原市,717861,359629,358232
142018,59,神奈川県,横須賀市,383488,190852,192636
142034,101,神奈川県,平塚市,256856,128093,128763
142042,153,神奈川県,鎌倉市,175625,83114,92511
142051,45,神奈川県,藤沢市,445172,220302,224870
142069,144,神奈川県,小田原市,187040,91215,95825
142077,106,神奈川県,茅ヶ崎市,247785,120542,127243
142085,459,神奈川県,逗子市,58510,27478,31032
142107,621,神奈川県,三浦市,40578,19692,20886
142115,168,神奈川県,秦野市,159257,79907,79350
142123,122,神奈川県,厚木市,223940,115579,108361
142131,109,神奈川県,大和市,245038,122306,122732
142140,280,神奈川県,伊勢原市,100156,50911,49245
142158,200,神奈川県,海老名市,139604,70224,69380
142166,210,神奈川県,座間市,131356,65819,65537
142174,620,神奈川県,南足柄市,40666,19965,20701
142182,326,神奈川県,綾瀬市,84100,42844,41256
143014,713,神奈川県,三浦郡葉山町,32272,15281,16991
143219,531,神奈川県,高座郡寒川町,49135,25001,24134
143413,719,神奈川県,中郡大磯町,32054,15678,16376
143421,793,神奈川県,中郡二宮町,27752,13411,14341
143618,1242,神奈川県,足柄上郡中井町,8932,4491,4441
143626,974,神奈川県,足柄上郡大井町,17473,8643,8830
143634,1186,神奈川県,足柄上郡松田町,10487,5183,5304
143642,1225,神奈川県,足柄上郡山北町,9435,4631,4804
143669,947,神奈川県,足柄上郡開成町,18649,9121,9528
143821,1170,神奈川県,足柄下郡箱根町,10907,5207,5700
143839,1342,神奈川県,足柄下郡真鶴町,6710,3127,3583
143847,863,神奈川県,足柄下郡湯河原町,23483,11064,12419
144011,631,神奈川県,愛甲郡愛川町,39498,20635,18863
144029,1592,神奈川県,愛甲郡清川村,2764,1413,1351
151009,17,新潟県,新潟市,767565,369463,398102
152021,100,新潟県,長岡市,258205,126510,131695
152048,304,新潟県,三条市,92359,45069,47290
152056,350,新潟県,柏崎市,77493,38274,39219
152064,303,新潟県,新発田市,92855,45302,47553
152081,694,新潟県,小千谷市,33186,16381,16805
152099,844,新潟県,加茂市,24569,11996,12573
152102,544,新潟県,十日町市,48128,23600,24528
152111,636,新潟県,見附市,38584,18847,19737
152129,486,新潟県,村上市,54765,26342,28423
152137,354,新潟県,燕市,76712,37559,39153
152161,634,新潟県,糸魚川市,38859,19023,19836
152170,758,新潟県,妙高市,29885,14605,15280
152188,564,新潟県,五泉市,46523,22459,24064
152226,148,新潟県,上越市,182911,89894,93017
152234,624,新潟県,阿賀野市,39873,19380,20493
152242,526,新潟県,佐渡市,49336,24040,25296
152251,696,新潟県,魚沼市,33149,16223,16926
152269,499,新潟県,南魚沼市,53320,26097,27223
152277,801,新潟県,胎内市,27284,13442,13842
153079,1074,新潟県,北蒲原郡聖籠町,14055,7043,7012
153427,1297,新潟県,西蒲原郡弥彦村,7591,3670,3921
153613,1179,新潟県,南蒲原郡田上町,10815,5213,5602
153851,1227,新潟県,東蒲原郡阿賀町,9416,4595,4821
154059,1513,新潟県,三島郡出雲崎町,3996,1923,2073
154610,1272,新潟県,南魚沼郡湯沢町,8122,4184,3938
154822,1252,新潟県,中魚沼郡津南町,8672,4211,4461
155047,1492,新潟県,刈羽郡刈羽村,4286,2168,2118
155811,1449,新潟県,岩船郡関川村,4835,2340,2495
155861,1738,新潟県,岩船郡粟島浦村,323,159,164
162019,53,富山県,富山市,406483,198368,208115
162027,164,富山県,高岡市,164053,79660,84393
162043,633,富山県,魚津市,39274,19238,20036
162051,594,富山県,氷見市,43205,20760,22445
162060,710,富山県,滑川市,32728,16082,16646
162078,628,富山県,黒部市,39697,19591,20106
162086,554,富山県,砺波市,47024,22939,24085
162094,778,富山県,小矢部市,28356,13916,14440
162108,556,富山県,南砺市,46949,22597,24352
162116,309,富山県,射水市,90997,44598,46399
163210,1548,富山県,中新川郡舟橋村,3299,1644,1655
163228,935,富山県,中新川郡上市町,19027,9141,9886
163236,845,富山県,中新川郡立山町,24567,11874,12693
163422,874,富山県,下新川郡入善町,22629,10939,11690
163431,1180,富山県,下新川郡朝日町,10716,5069,5647
172014,46,石川県,金沢市,444996,214606,230390
172022,542,石川県,七尾市,48268,23040,25228
172031,270,石川県,小松市,106104,52310,53794
172049,868,石川県,輪島市,23119,10924,12195
172057,1122,石川県,珠洲市,12574,5851,6723
172065,430,石川県,加賀市,62545,29829,32716
172073,919,石川県,羽咋市,19863,9422,10441
172090,661,石川県,かほく市,36024,17555,18469
172103,250,石川県,白山市,112652,55135,57517
172111,519,石川県,能美市,49697,24677,25020
172120,493,石川県,野々市市,54163,27336,26827
173240,1386,石川県,能美郡川北町,6099,3044,3055
173614,649,石川県,河北郡津幡町,37457,18385,19072
173657,820,石川県,河北郡内灘町,26030,12604,13426
173843,956,石川県,羽咋郡志賀町,18263,8745,9518
173860,1133,石川県,羽咋郡宝達志水町,12017,5771,6246
174076,989,石川県,鹿島郡中能登町,16821,8206,8615
174611,1306,石川県,鳳珠郡穴水町,7347,3537,3810
174637,1033,石川県,鳳珠郡能登町,15187,7239,7948
182010,102,福井県,福井市,255949,124232,131717
182028,425,福井県,敦賀市,62942,31055,31887
182044,787,福井県,小浜市,27974,13796,14178
182052,749,福井県,大野市,30451,14573,15878
182061,896,福井県,勝山市,21483,10265,11218
182079,407,福井県,鯖江市,68402,33440,34962
182087,811,福井県,あわら市,26537,12657,13880
182095,340,福井県,越前市,79907,39428,40479
182109,310,福井県,坂井市,88986,43360,45626
183229,964,福井県,吉田郡永平寺町,17900,8715,9185
183822,1634,福井県,今立郡池田町,2238,1079,1159
184047,1222,福井県,南条郡南越前町,9611,4653,4958
184233,916,福井県,丹生郡越前町,20100,9821,10279
184420,1246,福井県,三方郡美浜町,8842,4342,4500
184811,1219,福井県,大飯郡高浜町,9686,4863,4823
184837,1291,福井県,大飯郡おおい町,7757,3845,3912
185019,1088,福井県,三方上中郡若狭町,13625,6623,7002
192015,147,山梨県,甲府市,184827,89890,94937
192023,560,山梨県,富士吉田市,46770,22985,23785
192040,774,山梨県,都留市,28798,14045,14753
192058,697,山梨県,山梨市,33114,15921,17193
192066,888,山梨県,大月市,21742,10744,10998
192074,784,山梨県,韮崎市,28089,14089,14000
192082,389,山梨県,南アルプス市,71660,35579,36081
192091,569,山梨県,北杜市,45533,22308,23225
192104,357,山梨県,甲斐市,76514,37852,38662
192112,409,山梨県,笛吹市,67271,32793,34478
192121,891,山梨県,上野原市,21637,10854,10783
192139,762,山梨県,甲州市,29600,14337,15263
192147,745,山梨県,中央市,30657,15189,15468
193461,1047,山梨県,西八代郡市川三郷町,14693,7166,7527
193640,1712,山梨県,南巨摩郡早川町,884,445,439
193658,1208,山梨県,南巨摩郡身延町,10051,4922,5129
193666,1333,山梨県,南巨摩郡南部町,6920,3431,3489
193682,1072,山梨県,南巨摩郡富士川町,14127,6899,7228
193844,901,山梨県,中巨摩郡昭和町,21213,10627,10586
194221,1671,山梨県,南都留郡道志村,1545,779,766
194239,1509,山梨県,南都留郡西桂町,4001,1941,2060
194247,1216,山梨県,南都留郡忍野村,9758,5310,4448
194255,1409,山梨県,南都留郡山中湖村,5768,2914,2854
194298,1561,山梨県,南都留郡鳴沢村,3079,1557,1522
194301,803,山梨県,南都留郡富士河口湖町,26965,13277,13688
194425,1724,山梨県,北都留郡小菅村,639,327,312
194433,1729,山梨県,北都留郡丹波山村,514,271,243
202011,64,長野県,長野市,365572,177579,187993
202029,114,長野県,松本市,235475,115517,119958
202037,178,長野県,上田市,152484,74840,77644
202045,553,長野県,岡谷市,47038,22959,24079
202053,293,長野県,飯田市,96197,46545,49652
202061,545,長野県,諏訪市,48008,23672,24336
202070,524,長野県,須坂市,49582,24107,25475
202088,611,長野県,小諸市,41521,20382,21139
202096,421,長野県,伊那市,65357,32017,33340
202100,729,長野県,駒ヶ根市,31664,15689,15975
202118,603,長野県,中野市,42586,20767,21819
202126,829,長野県,大町市,25684,12505,13179
202134,931,長野県,飯山市,19214,9378,9836
202142,492,長野県,茅野市,54279,27130,27149
202151,418,長野県,塩尻市,65623,32858,32765
202177,288,長野県,佐久市,97676,48056,49620
202185,454,長野県,千曲市,59179,28857,30322
202193,768,長野県,東御市,29256,14554,14702
202207,292,長野県,安曇野市,96249,46769,49480
203033,1495,長野県,南佐久郡小海町,4247,2094,2153
203041,1524,長野県,南佐久郡川上村,3741,2027,1714
203050,1567,長野県,南佐久郡南牧村,3017,1567,1450
203068,1710,長野県,南佐久郡南相木村,931,452,479
203076,1722,長野県,南佐久郡北相木村,659,327,332
203092,1193,長野県,南佐久郡佐久穂町,10298,5035,5263
203211,893,長野県,北佐久郡軽井沢町,21599,10316,11283
203238,994,長野県,北佐久郡御代田町,16551,8194,8357
203246,1341,長野県,北佐久郡立科町,6724,3357,3367
203491,1501,長野県,小県郡青木村,4151,2036,2115
203505,1414,長野県,小県郡長和町,5605,2784,2821
203611,942,長野県,諏訪郡下諏訪町,18823,9080,9743
203629,1068,長野県,諏訪郡富士見町,14209,6979,7230
203637,1275,長野県,諏訪郡原村,8093,3962,4131
203823,955,長野県,上伊那郡辰野町,18289,8923,9366
203831,848,長野県,上伊那郡箕輪町,24463,12307,12156
203840,1241,長野県,上伊那郡飯島町,8955,4381,4574
203858,1006,長野県,上伊那郡南箕輪村,16109,8012,8097
203866,1467,長野県,上伊那郡中川村,4664,2238,2426
203882,1248,長野県,上伊那郡宮田村,8794,4315,4479
204021,1121,長野県,下伊那郡松川町,12659,6180,6479
204030,1115,長野県,下伊那郡高森町,12770,6254,6516
204048,1505,長野県,下伊那郡阿南町,4078,1987,2091
204072,1395,長野県,下伊那郡阿智村,5989,2934,3055
204099,1734,長野県,下伊那郡平谷村,375,182,193
204102,1715,長野県,下伊那郡根羽村,825,418,407
204111,1542,長野県,下伊那郡下條村,3479,1686,1793
204129,1731,長野県,下伊那郡売木村,473,223,250
204137,1702,長野県,下伊那郡天龍村,1088,512,576
204145,1676,長野県,下伊那郡泰阜村,1479,691,788
204153,1396,長野県,下伊那郡喬木村,5972,2947,3025
204161,1350,長野県,下伊那郡豊丘村,6570,3273,3297
204170,1711,長野県,下伊那郡大鹿村,887,432,455
204226,1508,長野県,木曽郡上松町,4001,1965,2036
204234,1523,長野県,木曽郡南木曽町,3765,1813,1952
204251,1605,長野県,木曽郡木祖村,2579,1206,1373
204293,1723,長野県,木曽郡王滝村,657,308,349
204307,1547,長野県,木曽郡大桑村,3322,1617,1705
204323,1209,長野県,木曽郡木曽町,10031,4829,5202
204463,1614,長野県,東筑摩郡麻績村,2471,1203,1268
204480,1663,長野県,東筑摩郡生坂村,1650,828,822
204501,1256,長野県,東筑摩郡山形村,8526,4216,4310
204510,1488,長野県,東筑摩郡朝日村,4317,2123,2194
204528,1506,長野県,東筑摩郡筑北村,4044,2017,2027
204811,1232,長野県,北安曇郡池田町,9239,4468,4771
204820,1224,長野県,北安曇郡松川村,9586,4649,4937
204854,1234,長野県,北安曇郡白馬村,9159,4653,4506
204862,1596,長野県,北安曇郡小谷村,2726,1410,1316
205214,1070,長野県,埴科郡坂城町,14132,7031,7101
205419,1164,長野県,上高井郡小布施町,10993,5282,5711
205435,1353,長野県,上高井郡高山村,6525,3258,3267
205613,1151,長野県,下高井郡山ノ内町,11398,5569,5829
205621,1487,長野県,下高井郡木島平村,4364,2151,2213
205630,1537,長野県,下高井郡野沢温泉村,3524,1714,1810
205834,1294,長野県,上水内郡信濃町,7698,3824,3874
205885,1631,長野県,上水内郡小川村,2263,1120,1143
205907,1189,長野県,上水内郡飯綱町,10364,5090,5274
206024,1668,長野県,下水内郡栄村,1591,754,837
212016,54,岐阜県,岐阜市,400937,191526,209411
212024,170,岐阜県,大垣市,158049,77247,80802
212032,330,岐阜県,高山市,83281,39814,43467
212041,268,岐阜県,多治見市,106181,51705,54476
212059,323,岐阜県,関市,84825,41599,43226
212067,369,岐阜県,中津川市,74532,36633,37899
212075,928,岐阜県,美濃市,19279,9311,9968
212083,667,岐阜県,瑞浪市,35731,17450,18281
212091,413,岐阜県,羽島市,66775,32939,33836
212105,557,岐阜県,恵那市,46868,22878,23990
212113,467,岐阜県,美濃加茂市,57540,28553,28987
212121,482,岐阜県,土岐市,54990,26756,28234
212130,188,岐阜県,各務原市,144940,71661,73279
212148,279,岐阜県,可児市,100207,49603,50604
212156,835,岐阜県,山県市,25233,12322,12911
212164,478,岐阜県,瑞穂市,56329,28096,28233
212172,882,岐阜県,飛騨市,22106,10719,11387
212181,698,岐阜県,本巣市,33109,16176,16933
212199,637,岐阜県,郡上市,38450,18839,19611
212202,763,岐阜県,下呂市,29495,14104,15391
212211,715,岐阜県,海津市,32084,15905,16179
213021,817,岐阜県,羽島郡岐南町,26227,13068,13159
213039,885,岐阜県,羽島郡笠松町,21816,10517,11299
213411,813,岐阜県,養老郡養老町,26397,13059,13338
213616,819,岐阜県,不破郡垂井町,26058,12890,13168
213624,1371,岐阜県,不破郡関ケ原町,6287,3046,3241
213811,952,岐阜県,安八郡神戸町,18409,8984,9425
213829,1231,岐阜県,安八郡輪之内町,9267,4640,4627
213837,1056,岐阜県,安八郡安八町,14465,7155,7310
214019,933,岐阜県,揖斐郡揖斐川町,19062,9239,9823
214035,886,岐阜県,揖斐郡大野町,21798,10760,11038
214043,873,岐阜県,揖斐郡池田町,22714,11194,11520
214213,945,岐阜県,本巣郡北方町,18697,8938,9759
215015,1268,岐阜県,加茂郡坂祝町,8213,4270,3943
215023,1405,岐阜県,加茂郡富加町,5847,2880,2967
215031,1214,岐阜県,加茂郡川辺町,9843,4858,4985
215040,1550,岐阜県,加茂郡七宗町,3290,1547,1743
215058,1203,岐阜県,加茂郡八百津町,10092,4898,5194
215066,1317,岐阜県,加茂郡白川町,7194,3383,3811
215074,1646,岐阜県,加茂郡東白川村,2072,980,1092
215210,969,岐阜県,可児郡御嵩町,17682,8864,8818
216046,1675,岐阜県,大野郡白川村,1491,736,755
221007,25,静岡県,静岡市,677736,330038,347698
221309,16,静岡県,浜松市,788985,393379,395606
222038,141,静岡県,沼津市,187826,92706,95120
222054,686,静岡県,熱海市,33934,15425,18509
222062,269,静岡県,三島市,106176,51923,54253
222071,215,静岡県,富士宮市,128169,63613,64556
222089,419,静岡県,伊東市,65433,31027,34406
222097,295,静岡県,島田市,95698,46907,48791
222101,105,静岡県,富士市,247887,122996,124891
222119,162,静岡県,磐田市,166684,84310,82374
222127,204,静岡県,焼津市,136343,67293,69050
222135,240,静岡県,掛川市,115419,58147,57272
222143,197,静岡県,藤枝市,140979,68953,72026
222151,325,静岡県,御殿場市,84240,43038,41202
222160,313,静岡県,袋井市,88429,44959,43470
222194,924,静岡県,下田市,19710,9550,10160
222208,530,静岡県,裾野市,49225,24777,24448
222216,462,静岡県,湖西市,58079,29923,28156
222224,780,静岡県,伊豆市,28271,13617,14654
222232,754,静岡県,御前崎市,30288,15411,14877
222241,548,静岡県,菊川市,47541,24060,23481
222259,561,静岡県,伊豆の国市,46664,22589,24075
222267,596,静岡県,牧之原市,43067,21406,21661
223018,1153,静岡県,賀茂郡東伊豆町,11305,5451,5854
223026,1351,静岡県,賀茂郡河津町,6552,3171,3381
223042,1300,静岡県,賀茂郡南伊豆町,7505,3622,3883
223051,1408,静岡県,賀茂郡松崎町,5824,2757,3067
223069,1337,静岡県,賀茂郡西伊豆町,6842,3266,3576
223255,657,静岡県,田方郡函南町,36650,18022,18628
223417,724,静岡県,駿東郡清水町,31823,15519,16304
223425,591,静岡県,駿東郡長泉町,43528,21466,22062
223441,977,静岡県,駿東郡小山町,17263,8774,8489
224243,769,静岡県,榛原郡吉田町,29255,14660,14595
224294,1403,静岡県,榛原郡川根本町,5907,2881,3026
224618,980,静岡県,周智郡森町,17232,8630,8602
231002,3,愛知県,名古屋市,2297745,1134172,1163573
232017,62,愛知県,豊橋市,368686,184910,183776
232025,58,愛知県,岡崎市,383915,194601,189314
232033,61,愛知県,一宮市,378496,184763,193733
232041,216,愛知県,瀬戸市,127411,62714,64697
232050,230,愛知県,半田市,117207,59265,57942
232068,81,愛知県,春日井市,307473,152474,154999
232076,145,愛知県,豊川市,186376,92995,93381
232084,446,愛知県,津島市,60129,29654,30475
232092,384,愛知県,碧南市,72534,37264,35270
232106,177,愛知県,刈谷市,152948,79945,73003
232114,50,愛知県,豊田市,416383,216647,199736
232122,139,愛知県,安城市,188418,96402,92016
232131,158,愛知県,西尾市,170258,86313,83945
232149,349,愛知県,蒲郡市,78140,38587,39553
232157,386,愛知県,犬山市,72005,35729,36276
232165,458,愛知県,常滑市,58621,29041,29580
232173,285,愛知県,江南市,98729,48450,50279
232190,182,愛知県,小牧市,149715,75545,74170
232203,208,愛知県,稲沢市,133592,66167,67425
232211,595,愛知県,新城市,43122,21522,21600
232220,247,愛知県,東海市,113354,58956,54398
232238,302,愛知県,大府市,93016,47264,45752
232246,329,愛知県,知多市,83610,42137,41473
232254,385,愛知県,知立市,72214,38020,34194
232262,328,愛知県,尾張旭市,83947,41084,42863
232271,528,愛知県,高浜市,49249,25740,23509
232289,546,愛知県,岩倉市,47839,23910,23929
232297,408,愛知県,豊明市,68038,34533,33505
232301,298,愛知県,日進市,94033,46789,47244
232319,455,愛知県,田原市,58855,29936,28919
232327,441,愛知県,愛西市,61128,29928,31200
232335,401,愛知県,清須市,68891,34628,34263
232343,319,愛知県,北名古屋市,86168,43128,43040
232351,588,愛知県,弥富市,43722,21918,21804
232360,436,愛知県,みよし市,61427,31468,29959
232378,311,愛知県,あま市,88756,44122,44634
232386,443,愛知県,長久手市,61113,30254,30859
233021,585,愛知県,愛知郡東郷町,43973,22099,21874
233421,1009,愛知県,西春日井郡豊山町,15917,8168,7749
233617,851,愛知県,丹羽郡大口町,24212,12269,11943
233625,675,愛知県,丹羽郡扶桑町,35104,17473,17631
234249,691,愛知県,海部郡大治町,33567,17012,16555
234257,654,愛知県,海部郡蟹江町,37098,18394,18704
234273,1462,愛知県,海部郡飛島村,4711,2413,2298
234419,779,愛知県,知多郡阿久比町,28318,14033,14285
234427,516,愛知県,知多郡東浦町,50204,25165,25039
234451,1008,愛知県,知多郡南知多町,16017,7879,8138
234460,908,愛知県,知多郡美浜町,20903,10346,10557
234478,593,愛知県,知多郡武豊町,43374,21887,21487
235016,604,愛知県,額田郡幸田町,42296,21501,20795
235610,1498,愛知県,北設楽郡設楽町,4188,2029,2159
235628,1590,愛知県,北設楽郡東栄町,2774,1353,1421
235636,1708,愛知県,北設楽郡豊根村,963,469,494
242012,91,三重県,津市,271000,131854,139146
242021,80,三重県,四日市市,307825,154683,153142
242039,224,三重県,伊勢市,120306,57066,63240
242047,172,三重県,松阪市,157316,75751,81565
242055,202,三重県,桑名市,138963,68825,70138
242071,135,三重県,鈴鹿市,195589,97759,97830
242080,366,三重県,名張市,75248,36257,38991
242098,1011,三重県,尾鷲市,15877,7331,8546
242101,527,三重県,亀山市,49313,25024,24289
242110,988,三重県,鳥羽市,16842,7975,8867
242128,1029,三重県,熊野市,15299,7074,8225
242144,576,三重県,いなべ市,44697,23005,21692
242152,571,三重県,志摩市,45114,21044,24070
242161,320,三重県,伊賀市,85989,42329,43660
243035,1398,三重県,桑名郡木曽岬町,5939,3082,2857
243248,823,三重県,員弁郡東員町,25838,12726,13112
243418,616,三重県,三重郡菰野町,41056,20380,20676
243434,1160,三重県,三重郡朝日町,11065,5503,5562
243442,1018,三重県,三重郡川越町,15643,8061,7582
244414,1082,三重県,多気郡多気町,13817,6645,7172
244422,871,三重県,多気郡明和町,22867,10998,11869
244431,1263,三重県,多気郡大台町,8411,3989,4422
244619,1037,三重県,度会郡玉城町,15107,7301,7806
244708,1293,三重県,度会郡度会町,7708,3745,3963
244716,1304,三重県,度会郡大紀町,7395,3521,3874
244724,1169,三重県,度会郡南伊勢町,10926,5105,5821
245437,1071,三重県,北牟婁郡紀北町,14131,6647,7484
245615,1287,三重県,南牟婁郡御浜町,7938,3735,4203
245623,1192,三重県,南牟婁郡紀宝町,10308,4846,5462
252018,71,滋賀県,大津市,343916,165604,178312
252026,258,滋賀県,彦根市,111118,55480,55638
252034,245,滋賀県,長浜市,113940,55753,58187
252042,338,滋賀県,近江八幡市,81875,40249,41626
252069,199,滋賀県,草津市,139939,70230,69709
252077,321,滋賀県,守山市,85856,42268,43588
252085,395,滋賀県,栗東市,70469,35083,35386
252093,312,滋賀県,甲賀市,88493,44456,44037
252107,512,滋賀県,野洲市,50711,25427,25284
252115,490,滋賀県,湖南市,54382,28278,26104
252123,568,滋賀県,高島市,45783,22393,23390
252131,254,滋賀県,東近江市,112064,56055,56009
252140,652,滋賀県,米原市,37375,18226,19149
253839,909,滋賀県,蒲生郡日野町,20861,10521,10340
253847,1150,滋賀県,蒲生郡竜王町,11433,5904,5529
254258,903,滋賀県,愛知郡愛荘町,21194,10631,10563
254410,1316,滋賀県,犬上郡豊郷町,7196,3542,3654
254428,1355,滋賀県,犬上郡甲良町,6511,3162,3349
254436,1303,滋賀県,犬上郡多賀町,7418,3617,3801
261009,8,京都府,京都市,1379529,652979,726550
262013,365,京都府,福知山市,75385,37445,37940
262021,353,京都府,舞鶴市,76732,38155,38577
262030,733,京都府,綾部市,31526,15160,16366
262048,151,京都府,宇治市,180943,87119,93824
262056,1000,京都府,宮津市,16325,7743,8582
262064,316,京都府,亀岡市,86765,42215,44550
262072,373,京都府,城陽市,74031,35653,38378
262081,475,京都府,向日市,56571,27145,29426
262099,334,京都府,長岡京市,82308,39841,42467
262102,399,京都府,八幡市,69219,33647,35572
262111,387,京都府,京田辺市,71865,35085,36780
262129,510,京都府,京丹後市,51031,24541,26490
262137,756,京都府,南丹市,30123,14634,15489
262145,341,京都府,木津川市,79828,38490,41338
263036,992,京都府,乙訓郡大山崎町,16651,8029,8622
263222,1026,京都府,久世郡久御山町,15387,7658,7729
263435,1326,京都府,綴喜郡井手町,6989,3420,3569
263443,1247,京都府,綴喜郡宇治田原町,8829,4460,4369
263648,1701,京都府,相楽郡笠置町,1116,537,579
263656,1540,京都府,相楽郡和束町,3499,1660,1839
263664,658,京都府,相楽郡精華町,36543,17561,18982
263672,1618,京都府,相楽郡南山城村,2447,1163,1284
264075,1117,京都府,船井郡京丹波町,12742,6095,6647
264636,1653,京都府,与謝郡伊根町,1914,938,976
264652,922,京都府,与謝郡与謝野町,19777,9492,10285
271004,2,大阪府,大阪市,2757642,1335043,1422599
271403,15,大阪府,堺市,817041,391137,425904
272027,140,大阪府,岸和田市,188002,90127,97875
272035,52,大阪府,豊中市,406836,193056,213780
272043,276,大阪府,池田市,102969,48999,53970
272051,60,大阪府,吹田市,382681,182436,200245
272060,380,大阪府,泉大津市,73145,34869,38276
272078,70,大阪府,高槻市,346972,165202,181770
272086,332,大阪府,貝塚市,82500,39776,42724
272094,195,大阪府,守口市,141243,68413,72830
272108,57,大阪府,枚方市,394221,188659,205562
272116,87,大阪府,茨木市,285715,137608,148107
272124,97,大阪府,八尾市,260752,124336,136416
272132,284,大阪府,泉佐野市,99037,47490,51547
272141,263,大阪府,富田林市,107342,50627,56715
272159,121,大阪府,寝屋川市,225735,108703,117032
272167,283,大阪府,河内長野市,99226,46702,52524
272175,232,大阪府,松原市,116669,56084,60585
272183,234,大阪府,大東市,116376,56603,59773
272191,149,大阪府,和泉市,182841,88343,94498
272205,201,大阪府,箕面市,139318,66691,72627
272213,411,大阪府,柏原市,66952,32175,34777
272221,261,大阪府,羽曳野市,108213,51433,56780
272230,231,大阪府,門真市,117139,57583,59556
272248,318,大阪府,摂津市,86351,42604,43747
272256,477,大阪府,高石市,56481,26836,29645
272264,427,大阪府,藤井寺市,62700,29813,32887
272272,39,大阪府,東大阪市,478539,232698,245841
272281,456,大阪府,泉南市,58789,28320,30469
272299,491,大阪府,四條畷市,54355,26438,27917
272302,352,大阪府,交野市,77272,37159,40113
272311,463,大阪府,大阪狭山市,58031,27277,30754
272329,511,大阪府,阪南市,50788,24207,26581
273015,728,大阪府,三島郡島本町,31681,14938,16743
273210,957,大阪府,豊能郡豊能町,18183,8659,9524
273228,1235,大阪府,豊能郡能勢町,9125,4430,4695
273414,993,大阪府,泉北郡忠岡町,16573,7998,8575
273619,600,大阪府,泉南郡熊取町,42854,20715,22139
273627,1259,大阪府,泉南郡田尻町,8493,4238,4255
273660,1055,大阪府,泉南郡岬町,14516,6791,7725
273813,1114,大阪府,南河内郡太子町,12813,6278,6535
273821,1045,大阪府,南河内郡河南町,14815,7249,7566
273830,1458,大阪府,南河内郡千早赤阪村,4782,2249,2533
281000,7,兵庫県,神戸市,1500425,710051,790374
282014,33,兵庫県,姫路市,525884,255146,270738
282022,44,兵庫県,尼崎市,458046,222279,235767
282031,82,兵庫県,明石市,306760,147876,158884
282049,38,兵庫県,西宮市,482594,227322,255272
282057,613,兵庫県,洲本市,41339,19724,21615
282065,296,兵庫県,芦屋市,94780,42768,52012
282073,132,兵庫県,伊丹市,201383,97421,103962
282081,799,兵庫県,相生市,27468,13290,14178
282090,355,兵庫県,豊岡市,76574,36864,39710
282103,99,兵庫県,加古川市,258691,126683,132008
282120,574,兵庫県,赤穂市,44816,21657,23159
282138,643,兵庫県,西脇市,38185,18352,19833
282146,119,兵庫県,宝塚市,228934,106052,122882
282154,374,兵庫県,三木市,74028,35741,38287
282162,315,兵庫県,高砂市,87360,42390,44970
282171,175,兵庫県,川西市,154071,72641,81430
282189,551,兵庫県,小野市,47166,23121,24045
282197,264,兵庫県,三田市,107208,51863,55345
282201,608,兵庫県,加西市,41944,20594,21350
282219,630,兵庫県,丹波篠山市,39647,18984,20663
282227,895,兵庫県,養父市,21489,10315,11174
282235,444,兵庫県,丹波市,60897,29399,31498
282243,577,兵庫県,南あわじ市,44469,21430,23039
282251,781,兵庫県,朝来市,28239,13582,14657
282260,607,兵庫県,淡路市,41969,20097,21872
282278,682,兵庫県,宍粟市,34572,16599,17973
282286,629,兵庫県,加東市,39681,19635,20046
282294,378,兵庫県,たつの市,73201,35526,37675
283011,771,兵庫県,川辺郡猪名川町,29100,13871,15229
283657,938,兵庫県,多可郡多可町,18966,9262,9704
283819,746,兵庫県,加古郡稲美町,30599,15070,15529
283827,678,兵庫県,加古郡播磨町,34916,17101,17815
284424,1173,兵庫県,神崎郡市川町,10897,5315,5582
284432,943,兵庫県,神崎郡福崎町,18767,9035,9732
284467,1188,兵庫県,神崎郡神河町,10391,4952,5439
284645,690,兵庫県,揖保郡太子町,33577,16467,17110
284815,1078,兵庫県,赤穂郡上郡町,13913,6798,7115
285013,1036,兵庫県,佐用郡佐用町,15166,7306,7860
285854,1016,兵庫県,美方郡香美町,15657,7445,8212
285862,1101,兵庫県,美方郡新温泉町,13094,6275,6819
292010,68,奈良県,奈良市,349385,163203,186182
292028,431,奈良県,大和高田市,62413,29346,33067
292036,331,奈良県,大和郡山市,83255,39395,43860
292044,439,奈良県,天理市,61328,29970,31358
292052,225,奈良県,橿原市,119250,56588,62662
292061,485,奈良県,桜井市,54878,25976,28902
292079,798,奈良県,五條市,27477,13128,14349
292087,859,奈良県,御所市,23677,11108,12569
292095,229,奈良県,生駒市,117332,55752,61580
292109,345,奈良県,香芝市,78585,37535,41050
292117,645,奈良県,葛城市,37905,18218,19687
292125,800,奈良県,宇陀市,27346,13111,14235
293229,1558,奈良県,山辺郡山添村,3130,1500,1630
293423,954,奈良県,生駒郡平群町,18319,8641,9678
293431,877,奈良県,生駒郡三郷町,22479,10747,11732
293440,783,奈良県,生駒郡斑鳩町,28134,13347,14787
293458,1321,奈良県,生駒郡安堵町,7056,3342,3714
293610,1274,奈良県,磯城郡川西町,8094,3939,4155
293628,1356,奈良県,磯城郡三宅町,6502,3101,3401
293636,731,奈良県,磯城郡田原本町,31570,15151,16419
293857,1688,奈良県,宇陀郡曽爾村,1296,596,700
293865,1681,奈良県,宇陀郡御杖村,1412,668,744
294012,1377,奈良県,高市郡高取町,6187,2940,3247
294021,1437,奈良県,高市郡明日香村,5168,2498,2670
294241,900,奈良県,北葛城郡上牧町,21367,10153,11214
294250,855,奈良県,北葛城郡王寺町,23858,11285,12573
294268,674,奈良県,北葛城郡広陵町,35159,16898,18261
294276,990,奈良県,北葛城郡河合町,16818,7831,8987
294411,1388,奈良県,吉野郡吉野町,6036,2780,3256
294420,1005,奈良県,吉野郡大淀町,16147,7728,8419
294438,1475,奈良県,吉野郡下市町,4595,2161,2434
294446,1726,奈良県,吉野郡黒滝村,612,296,316
294462,1695,奈良県,吉野郡天川村,1231,597,634
294471,1737,奈良県,吉野郡野迫川村,334,165,169
294497,1579,奈良県,吉野郡十津川村,2850,1439,1411
294501,1716,奈良県,吉野郡下北山村,811,375,436
294519,1732,奈良県,吉野郡上北山村,440,229,211
294527,1694,奈良県,吉野郡川上村,1233,591,642
294535,1672,奈良県,吉野郡東吉野村,1538,720,818
302015,66,和歌山県,和歌山市,356472,168812,187660
302023,552,和歌山県,海南市,47158,22030,25128
302031,451,和歌山県,橋本市,59475,28131,31344
302040,828,和歌山県,有田市,25721,12242,13479
302058,894,和歌山県,御坊市,21540,10260,11280
302066,406,和歌山県,田辺市,68448,32165,36283
302074,815,和歌山県,新宮市,26333,12249,14084
302082,450,和歌山県,紀の川市,59578,28359,31219
302091,494,和歌山県,岩出市,54059,26058,28001
303046,1288,和歌山県,海草郡紀美野町,7912,3675,4237
303411,1019,和歌山県,伊都郡かつらぎ町,15625,7388,8237
303437,1517,和歌山県,伊都郡九度山町,3888,1772,2116
303445,1598,和歌山県,伊都郡高野町,2676,1307,1369
303615,1167,和歌山県,有田郡湯浅町,10944,5142,5802
303623,1352,和歌山県,有田郡広川町,6545,3130,3415
303666,833,和歌山県,有田郡有田川町,25412,12051,13361
303810,1360,和歌山県,日高郡美浜町,6452,3020,3432
303828,1283,和歌山県,日高郡日高町,7986,3840,4146
303836,1436,和歌山県,日高郡由良町,5183,2554,2629
303909,1290,和歌山県,日高郡印南町,7757,3684,4073
303917,1139,和歌山県,日高郡みなべ町,11767,5599,6168
303925,1233,和歌山県,日高郡日高川町,9202,4443,4759
304018,915,和歌山県,西牟婁郡白浜町,20161,9557,10604
304042,1013,和歌山県,西牟婁郡上富田町,15720,7520,8200
304069,1529,和歌山県,西牟婁郡すさみ町,3607,1739,1868
304212,1083,和歌山県,東牟婁郡那智勝浦町,13778,6454,7324
304221,1580,和歌山県,東牟婁郡太地町,2844,1277,1567
304247,1622,和歌山県,東牟婁郡古座川町,2363,1106,1257
304271,1733,和歌山県,東牟婁郡北山村,394,182,212
304280,1064,和歌山県,東牟婁郡串本町,14297,6768,7529
312011,150,鳥取県,鳥取市,181203,87536,93667
312029,186,鳥取県,米子市,145163,69283,75880
312037,582,鳥取県,倉吉市,44212,20991,23221
312045,711,鳥取県,境港市,32696,15760,16936
313025,1172,鳥取県,岩美郡岩美町,10903,5282,5621
313254,1591,鳥取県,八頭郡若桜町,2766,1331,1435
313289,1373,鳥取県,八頭郡智頭町,6257,2907,3350
313297,1012,鳥取県,八頭郡八頭町,15748,7561,8187
313645,1399,鳥取県,東伯郡三朝町,5936,2870,3066
313700,999,鳥取県,東伯郡湯梨浜町,16334,7830,8504
313718,1004,鳥取県,東伯郡琴浦町,16165,7674,8491
313726,1062,鳥取県,東伯郡北栄町,14327,6900,7427
313840,1528,鳥取県,西伯郡日吉津村,3620,1712,1908
313866,1040,鳥取県,西伯郡大山町,15048,7269,7779
313891,1195,鳥取県,西伯郡南部町,10272,4929,5343
313904,1194,鳥取県,西伯郡伯耆町,10297,4939,5358
314013,1511,鳥取県,日野郡日南町,3998,1896,2102
314021,1594,鳥取県,日野郡日野町,2742,1256,1486
314030,1608,鳥取県,日野郡江府町,2520,1172,1348
322016,134,島根県,松江市,196021,94300,101721
322024,520,島根県,浜田市,49678,23869,25809
322032,155,島根県,出雲市,172607,83871,88736
322041,589,島根県,益田市,43708,20678,23030
322059,714,島根県,大田市,32195,15482,16713
322067,664,島根県,安来市,35855,17270,18585
322075,887,島根県,江津市,21751,10212,11539
322091,676,島根県,雲南市,35085,17011,18074
323438,1152,島根県,仁多郡奥出雲町,11339,5452,5887
323861,1482,島根県,飯石郡飯南町,4482,2136,2346
324418,1565,島根県,邑智郡川本町,3034,1436,1598
324485,1502,島根県,邑智郡美郷町,4134,1991,2143
324493,1218,島根県,邑智郡邑南町,9734,4682,5052
325015,1349,島根県,鹿足郡津和野町,6583,3095,3488
325058,1412,島根県,鹿足郡吉賀町,5717,2749,2968
325252,1636,島根県,隠岐郡海士町,2214,1060,1154
325261,1607,島根県,隠岐郡西ノ島町,2548,1285,1263
325279,1727,島根県,隠岐郡知夫村,592,301,291
325287,1094,島根県,隠岐郡隠岐の島町,13347,6549,6798
331007,22,岡山県,岡山市,698671,336136,362535
332020,40,岡山県,倉敷市,475914,231926,243988
332038,291,岡山県,津山市,96314,46369,49945
332046,483,岡山県,玉野市,54946,26784,28162
332054,575,岡山県,笠岡市,44773,21630,23143
332071,651,岡山県,井原市,37396,17965,19431
332089,398,岡山県,総社市,69731,33890,35841
332097,805,岡山県,高梁市,26861,13067,13794
332101,808,岡山県,新見市,26657,12711,13946
332119,734,岡山県,備前市,31411,15163,16248
332127,659,岡山県,瀬戸内市,36484,17657,18827
332135,597,岡山県,赤磐市,42973,20678,22295
332143,609,岡山県,真庭市,41685,20022,21663
332151,831,岡山県,美作市,25524,12352,13172
332160,700,岡山県,浅口市,32987,15990,16997
333468,1100,岡山県,和気郡和気町,13151,6347,6804
334235,1116,岡山県,都窪郡早島町,12764,6151,6613
334456,1163,岡山県,浅口郡里庄町,11007,5314,5693
334618,1096,岡山県,小田郡矢掛町,13273,6408,6865
335860,1714,岡山県,真庭郡新庄村,832,396,436
336068,1130,岡山県,苫田郡鏡野町,12265,5940,6325
336220,1177,岡山県,勝田郡勝央町,10833,5227,5606
336238,1411,岡山県,勝田郡奈義町,5735,2876,2859
336432,1686,岡山県,英田郡西粟倉村,1340,636,704
336637,1485,岡山県,久米郡久米南町,4406,2095,2311
336661,1112,岡山県,久米郡美咲町,12845,6151,6694
336815,1190,岡山県,加賀郡吉備中央町,10347,4998,5349
341002,10,広島県,広島市,1178773,570210,608563
342025,131,広島県,呉市,205349,99383,105966
342033,869,広島県,竹原市,23064,11033,12031
342041,314,広島県,三原市,88128,42468,45660
342050,214,広島県,尾道市,128324,62429,65895
342076,43,広島県,福山市,458192,223621,234571
342084,665,広島県,府中市,35847,17314,18533
342092,538,広島県,三次市,48768,23505,25263
342106,721,広島県,庄原市,32005,15305,16700
342114,827,広島県,大竹市,25741,12605,13136
342122,137,広島県,東広島市,190516,95972,94544
342131,236,広島県,廿日市市,116025,55884,60141
342149,809,広島県,安芸高田市,26611,12871,13740
342157,906,広島県,江田島市,20996,10382,10614
343021,503,広島県,安芸郡府中町,52642,25826,26816
343048,741,広島県,安芸郡海田町,30840,15300,15540
343072,860,広島県,安芸郡熊野町,23542,11382,12160
343099,1120,広島県,安芸郡坂町,12680,6097,6583
343684,1417,広島県,山県郡安芸太田町,5550,2588,2962
343692,982,広島県,山県郡北広島町,17164,8445,8719
344311,1334,広島県,豊田郡大崎上島町,6908,3472,3436
344621,1044,広島県,世羅郡世羅町,14841,7085,7756
345458,1282,広島県,神石郡神石高原町,8034,3872,4162
352012,107,山口県,下関市,247000,115221,131779
352021,169,山口県,宇部市,158497,75792,82705
352039,142,山口県,山口市,187494,89598,97896
352047,601,山口県,萩市,42709,19847,22862
352063,246,山口県,防府市,113888,55551,58337
352071,472,山口県,下松市,56866,28014,28852
352080,217,山口県,岩国市,126812,60517,66295
352101,535,山口県,光市,48854,23367,25487
352110,740,山口県,長門市,30920,14352,16568
352128,761,山口県,柳井市,29683,13870,15813
352136,897,山口県,美祢市,21476,10160,11316
352152,205,山口県,周南市,136179,66299,69880
352161,452,山口県,山陽小野田市,59459,28396,31063
353051,1079,山口県,大島郡周防大島町,13897,6478,7419
353213,1406,山口県,玖珂郡和木町,5842,2879,2963
353418,1629,山口県,熊毛郡上関町,2269,1073,1196
353434,1060,山口県,熊毛郡田布施町,14340,6878,7462
353442,1174,山口県,熊毛郡平生町,10896,5182,5714
355020,1566,山口県,阿武郡阿武町,3028,1367,1661
362018,108,徳島県,徳島市,246967,117602,129365
362026,495,徳島県,鳴門市,54033,25917,28116
362034,672,徳島県,小松島市,35393,17229,18164
362042,400,徳島県,阿南市,68969,33542,35427
362051,641,徳島県,吉野川市,38265,18124,20141
362069,681,徳島県,阿波市,34773,16738,18035
362077,806,徳島県,美馬市,26762,12868,13894
362085,872,徳島県,三好市,22861,10867,11994
363014,1463,徳島県,勝浦郡勝浦町,4694,2273,2421
363022,1682,徳島県,勝浦郡上勝町,1402,658,744
363219,1641,徳島県,名東郡佐那河内村,2141,1037,1104
363413,839,徳島県,名西郡石井町,24868,11836,13032
363421,1459,徳島県,名西郡神山町,4777,2288,2489
363685,1313,徳島県,那賀郡那賀町,7278,3483,3795
363839,1532,徳島県,海部郡牟岐町,3575,1680,1895
363871,1402,徳島県,海部郡美波町,5917,2789,3128
363880,1264,徳島県,海部郡海陽町,8402,3995,4407
364011,1052,徳島県,板野郡松茂町,14566,7274,7292
364029,858,徳島県,板野郡北島町,23680,11535,12145
364037,671,徳島県,板野郡藍住町,35413,17082,18331
364045,1107,徳島県,板野郡板野町,12947,6233,6714
364053,1154,徳島県,板野郡上板町,11302,5455,5847
364681,1295,徳島県,美馬郡つるぎ町,7622,3599,4023
364894,1092,徳島県,三好郡東みよし町,13405,6453,6952
372013,49,香川県,高松市,419739,202820,216919
372021,257,香川県,丸亀市,111196,54421,56775
372030,515,香川県,坂出市,50349,24344,26005
372048,753,香川県,善通寺市,30338,15144,15194
372056,468,香川県,観音寺市,57071,27518,29553
372064,572,香川県,さぬき市,45108,21753,23355
372072,789,香川県,東かがわ市,27900,13294,14606
372081,437,香川県,三豊市,61407,29647,31760
373222,1118,香川県,小豆郡土庄町,12740,6041,6699
373249,1095,香川県,小豆郡小豆島町,13337,6412,6925
373419,802,香川県,木田郡三木町,27096,13109,13987
373648,1572,香川県,香川郡直島町,2945,1522,1423
373869,951,香川県,綾歌郡宇多津町,18455,9028,9427
373877,867,香川県,綾歌郡綾川町,23189,11356,11833
374032,1267,香川県,仲多度郡琴平町,8294,3884,4410
374041,883,香川県,仲多度郡多度津町,22071,11180,10891
374067,975,香川県,仲多度郡まんのう町,17350,8421,8929
382019,35,愛媛県,松山市,500231,234881,265350
382027,181,愛媛県,今治市,149730,71432,78298
382035,405,愛媛県,宇和島市,68585,32321,36264
382043,744,愛媛県,八幡浜市,30739,14471,16268
382051,244,愛媛県,新居浜市,114070,55058,59012
382060,272,愛媛県,西条市,104474,50737,53737
382078,625,愛媛県,大洲市,39867,19135,20732
382108,670,愛媛県,伊予市,35518,16821,18697
382132,336,愛媛県,四国中央市,82202,40363,41839
382141,683,愛媛県,西予市,34538,16425,18113
382159,695,愛媛県,東温市,33153,15688,17465
383562,1378,愛媛県,越智郡上島町,6180,3245,2935
383864,1318,愛媛県,上浮穴郡久万高原町,7145,3443,3702
384011,752,愛媛県,伊予郡松前町,30412,14341,16071
384020,912,愛媛県,伊予郡砥部町,20375,9655,10720
384224,1038,愛媛県,喜多郡内子町,15081,7255,7826
384429,1279,愛媛県,西宇和郡伊方町,8062,3903,4159
384844,1531,愛媛県,北宇和郡松野町,3580,1703,1877
384887,1229,愛媛県,北宇和郡鬼北町,9318,4357,4961
385069,934,愛媛県,南宇和郡愛南町,19038,9021,10017
392014,77,高知県,高知市,316410,148019,168391
392022,1143,高知県,室戸市,11671,5652,6019
392031,1010,高知県,安芸市,15900,7566,8334
392049,566,高知県,南国市,46133,22031,24102
392057,821,高知県,土佐市,25975,12632,13343
392065,921,高知県,須崎市,19829,9805,10024
392081,940,高知県,宿毛市,18869,8852,10017
392090,1135,高知県,土佐清水市,11950,5670,6280
392103,723,高知県,四万十市,31936,15166,16770
392111,703,高知県,香南市,32902,15991,16911
392120,838,高知県,香美市,25000,11933,13067
393011,1643,高知県,安芸郡東洋町,2118,1024,1094
393029,1576,高知県,安芸郡奈半利町,2922,1368,1554
393037,1613,高知県,安芸郡田野町,2472,1170,1302
393045,1624,高知県,安芸郡安田町,2345,1161,1184
393053,1698,高知県,安芸郡北川村,1203,587,616
393061,1717,高知県,安芸郡馬路村,799,382,417
393070,1533,高知県,安芸郡芸西村,3573,1704,1869
393410,1555,高知県,長岡郡本山町,3206,1519,1687
393444,1560,高知県,長岡郡大豊町,3095,1440,1655
393631,1539,高知県,土佐郡土佐町,3522,1723,1799
393649,1736,高知県,土佐郡大川村,355,177,178
393860,904,高知県,吾川郡いの町,21183,10138,11045
393878,1469,高知県,吾川郡仁淀川町,4655,2258,2397
394017,1397,高知県,高岡郡中土佐町,5941,2794,3147
394025,1134,高知県,高岡郡佐川町,12013,5661,6352
394033,1445,高知県,高岡郡越知町,4939,2325,2614
394050,1556,高知県,高岡郡檮原町,3175,1538,1637
394106,1456,高知県,高岡郡日高村,4807,2279,2528
394114,1428,高知県,高岡郡津野町,5326,2518,2808
394122,1025,高知県,高岡郡四万十町,15398,7400,7998
394246,1483,高知県,幡多郡大月町,4477,2204,2273
394271,1679,高知県,幡多郡三原村,1415,693,722
394289,1202,高知県,幡多郡黒潮町,10109,4828,5281
401005,13,福岡県,北九州市,921241,437435,483806
401307,5,福岡県,福岡市,1593919,755213,838706
402028,265,福岡県,大牟田市,106597,49619,56978
402036,84,福岡県,久留米市,301517,143179,158338
402044,480,福岡県,直方市,55164,26141,29023
402052,219,福岡県,飯塚市,124962,59649,65313
402061,570,福岡県,田川市,45389,21109,24280
402079,432,福岡県,柳川市,62365,29625,32740
402109,447,福岡県,八女市,60103,28568,31535
402117,529,福岡県,筑後市,49238,23769,25469
402125,727,福岡県,大川市,31692,15054,16638
402133,383,福岡県,行橋市,72612,35192,37420
402141,856,福岡県,豊前市,23853,11289,12564
402150,632,福岡県,中間市,39458,18574,20884
402168,449,福岡県,小郡市,59615,28274,31341
402176,266,福岡県,筑紫野市,106569,50990,55579
402184,252,福岡県,春日市,112241,54214,58027
402192,274,福岡県,大野城市,103116,49739,53377
402206,289,福岡県,宗像市,97065,46429,50636
402214,390,福岡県,太宰府市,71557,34291,37266
402231,453,福岡県,古賀市,59225,28448,30777
402249,403,福岡県,福津市,68793,32584,36209
402257,792,福岡県,うきは市,27774,13219,14555
402265,812,福岡県,宮若市,26526,12873,13653
402273,677,福岡県,嘉麻市,34929,16366,18563
402281,514,福岡県,朝倉市,50571,23992,26579
402290,679,福岡県,みやま市,34910,16347,18563
402303,273,福岡県,糸島市,103833,49922,53911
402311,522,福岡県,那珂川市,49663,24001,25662
403415,655,福岡県,糟屋郡宇美町,36999,18160,18839
403423,736,福岡県,糟屋郡篠栗町,31156,15126,16030
403431,563,福岡県,糟屋郡志免町,46572,22522,24050
403440,767,福岡県,糟屋郡須惠町,29300,14344,14956
403458,693,福岡県,糟屋郡新宮町,33251,16053,17198
403482,1228,福岡県,糟屋郡久山町,9330,4449,4881
403491,537,福岡県,糟屋郡粕屋町,48777,24150,24627
403814,1108,福岡県,遠賀郡芦屋町,12942,6284,6658
403822,795,福岡県,遠賀郡水巻町,27651,13064,14587
403831,732,福岡県,遠賀郡岡垣町,31552,14998,16554
403849,936,福岡県,遠賀郡遠賀町,18999,9031,9968
404012,1323,福岡県,鞍手郡小竹町,7030,3405,3625
404021,1041,福岡県,鞍手郡鞍手町,14998,7132,7866
404217,1111,福岡県,嘉穂郡桂川町,12873,6107,6766
404471,750,福岡県,朝倉郡筑前町,30441,14698,15743
404489,1655,福岡県,朝倉郡東峰村,1841,871,970
405035,1007,福岡県,三井郡大刀洗町,16084,7748,8336
405221,1086,福岡県,三潴郡大木町,13709,6560,7149
405442,929,福岡県,八女郡広川町,19273,9374,9899
406015,1197,福岡県,田川郡香春町,10166,4762,5404
406023,1258,福岡県,田川郡添田町,8512,4027,4485
406040,1262,福岡県,田川郡糸田町,8448,3986,4462
406058,1032,福岡県,田川郡川崎町,15218,7161,8057
406082,1441,福岡県,田川郡大任町,5062,2318,2744
406091,1578,福岡県,田川郡赤村,2890,1350,1540
406104,902,福岡県,田川郡福智町,21201,10149,11052
406210,647,福岡県,京都郡苅田町,37824,19588,18236
406252,960,福岡県,京都郡みやこ町,18049,8612,9437
406422,1347,福岡県,築上郡吉富町,6607,3165,3442
406465,1314,福岡県,築上郡上毛町,7261,3466,3795
406473,987,福岡県,築上郡築上町,16866,8267,8599
412015,120,佐賀県,佐賀市,228042,107811,120231
412023,239,佐賀県,唐津市,115475,54472,61003
412031,370,佐賀県,鳥栖市,74492,36155,38337
412040,961,佐賀県,多久市,17988,8604,9384
412058,506,佐賀県,伊万里市,52279,25524,26755
412066,549,佐賀県,武雄市,47472,22648,24824
412074,796,佐賀県,鹿島市,27596,13053,14543
412082,581,佐賀県,小城市,44259,21181,23078
412091,841,佐賀県,嬉野市,24760,11665,13095
412104,751,佐賀県,神埼市,30438,14724,15714
413275,1003,佐賀県,神埼郡吉野ヶ里町,16188,7901,8287
413411,971,佐賀県,三養基郡基山町,17575,8339,9236
413453,1215,佐賀県,三養基郡上峰町,9818,4741,5077
413461,825,佐賀県,三養基郡みやき町,25759,12392,13367
413879,1444,佐賀県,東松浦郡玄海町,4966,2537,2429
414018,941,佐賀県,西松浦郡有田町,18840,8847,9993
414239,1387,佐賀県,杵島郡大町町,6044,2813,3231
414247,1223,佐賀県,杵島郡江北町,9593,4565,5028
414255,899,佐賀県,杵島郡白石町,21398,10153,11245
414417,1276,佐賀県,藤津郡太良町,8069,3882,4187
422011,56,長崎県,長崎市,395843,183274,212569
422029,113,長崎県,佐世保市,236906,112389,124517
422037,602,長崎県,島原市,42641,19887,22754
422045,207,長崎県,諫早市,133938,63995,69943
422053,286,長崎県,大村市,98658,47356,51302
422070,775,長崎県,平戸市,28537,13559,14978
422088,907,長崎県,松浦市,20983,10135,10848
422096,791,長崎県,対馬市,27821,13797,14024
422100,849,長崎県,壱岐市,24360,11701,12659
422118,684,長崎県,五島市,34491,16444,18047
422126,832,長崎県,西海市,25437,12671,12766
422134,614,長崎県,雲仙市,41272,19721,21551
422142,610,長崎県,南島原市,41652,19437,22215
423076,626,長崎県,西彼杵郡長与町,39861,18969,20892
423084,764,長崎県,西彼杵郡時津町,29493,14236,15257
423211,1302,長崎県,東彼杵郡東彼杵町,7453,3582,3871
423220,1099,長崎県,東彼杵郡川棚町,13192,6225,6967
423238,1069,長崎県,東彼杵郡波佐見町,14157,6709,7448
423831,1639,長崎県,北松浦郡小値賀町,2181,1022,1159
423912,1076,長崎県,北松浦郡佐々町,13988,6707,7281
424111,983,長崎県,南松浦郡新上五島町,17130,8251,8879
431001,20,熊本県,熊本市,731722,346245,385477
432024,223,熊本県,八代市,121657,56627,65030
432032,755,熊本県,人吉市,30192,14093,16099
432041,523,熊本県,荒尾市,49641,23522,26119
432059,881,熊本県,水俣市,22133,10312,11821
432067,424,熊本県,玉名市,63537,30656,32881
432083,539,熊本県,山鹿市,48639,22970,25669
432105,559,熊本県,菊池市,46814,22534,24280
432113,660,熊本県,宇土市,36371,17511,18860
432121,850,熊本県,上天草市,24285,11568,12717
432130,469,熊本県,宇城市,56956,27339,29617
432148,847,熊本県,阿蘇市,24526,11582,12944
432156,376,熊本県,天草市,73437,34714,38723
432164,422,熊本県,合志市,64751,31419,33332
433489,1244,熊本県,下益城郡美里町,8873,4223,4650
433641,1435,熊本県,玉名郡玉東町,5191,2472,2719
433675,1245,熊本県,玉名郡南関町,8856,4257,4599
433683,1022,熊本県,玉名郡長洲町,15456,7818,7638
433691,1237,熊本県,玉名郡和水町,9104,4376,4728
434035,662,熊本県,菊池郡大津町,36013,17926,18087
434043,586,熊本県,菊池郡菊陽町,43915,21670,22245
434230,1519,熊本県,阿蘇郡南小国町,3875,1857,2018
434248,1358,熊本県,阿蘇郡小国町,6465,3087,3378
434256,1683,熊本県,阿蘇郡産山村,1395,730,665
434281,1400,熊本県,阿蘇郡高森町,5934,2877,3057
434329,1330,熊本県,阿蘇郡西原村,6955,3419,3536
434337,1201,熊本県,阿蘇郡南阿蘇村,10115,4912,5203
434418,979,熊本県,上益城郡御船町,17235,8304,8931
434426,1198,熊本県,上益城郡嘉島町,10159,4944,5215
434434,685,熊本県,上益城郡益城町,34041,16436,17605
434442,1200,熊本県,上益城郡甲佐町,10146,4877,5269
434477,1097,熊本県,上益城郡山都町,13272,6431,6841
434680,1166,熊本県,八代郡氷川町,10944,5028,5916
434825,1031,熊本県,葦北郡芦北町,15284,7261,8023
434841,1496,熊本県,葦北郡津奈木町,4216,2002,2214
435015,1196,熊本県,球磨郡錦町,10223,4853,5370
435058,1255,熊本県,球磨郡多良木町,8554,4031,4523
435066,1538,熊本県,球磨郡湯前町,3522,1668,1854
435074,1649,熊本県,球磨郡水上村,1976,932,1044
435104,1507,熊本県,球磨郡相良村,4019,1921,2098
435112,1709,熊本県,球磨郡五木村,942,458,484
435121,1554,熊本県,球磨郡山江村,3221,1494,1727
435139,1588,熊本県,球磨郡球磨村,2786,1342,1444
435147,1059,熊本県,球磨郡あさぎり町,14341,6717,7624
435317,1363,熊本県,天草郡苓北町,6409,3046,3363
442011,41,大分県,大分市,474665,228221,246444
442020,249,大分県,別府市,112926,51937,60989
442038,335,大分県,中津市,82221,40223,41998
442046,442,大分県,日田市,61125,29087,32038
442054,417,大分県,佐伯市,65624,30661,34963
442062,669,大分県,臼杵市,35620,16958,18662
442071,1027,大分県,津久見市,15386,7268,8118
442089,927,大分県,竹田市,19380,9125,10255
442097,884,大分県,豊後高田市,21960,10518,11442
442101,807,大分県,杵築市,26711,13076,13635
442119,500,大分県,宇佐市,52745,25111,27634
442127,709,大分県,豊後大野市,32765,15351,17414
442135,689,大分県,由布市,33580,16041,17539
442143,826,大分県,国東市,25756,12458,13298
443221,1659,大分県,東国東郡姫島村,1757,847,910
443417,786,大分県,速見郡日出町,28020,13476,14544
444618,1257,大分県,玖珠郡九重町,8523,4103,4420
444626,1073,大分県,玖珠郡玖珠町,14063,6778,7285
452017,55,宮崎県,宮崎市,397406,187616,209790
452025,167,宮崎県,都城市,161515,76453,85062
452033,237,宮崎県,延岡市,115847,55134,60713
452041,533,宮崎県,日南市,49037,23274,25763
452050,599,宮崎県,小林市,42944,20112,22832
452068,457,宮崎県,日向市,58687,28148,30539
452076,996,宮崎県,串間市,16517,7823,8694
452084,777,宮崎県,西都市,28503,13571,14932
452092,972,宮崎県,えびの市,17525,8277,9248
453412,822,宮崎県,北諸県郡三股町,25878,12246,13632
453617,1253,宮崎県,西諸県郡高原町,8590,4105,4485
453820,953,宮崎県,東諸県郡国富町,18405,8716,9689
453838,1332,宮崎県,東諸県郡綾町,6941,3299,3642
454010,925,宮崎県,児湯郡高鍋町,19498,9241,10257
454028,991,宮崎県,児湯郡新富町,16718,8225,8493
454036,1706,宮崎県,児湯郡西米良村,1021,528,493
454044,1452,宮崎県,児湯郡木城町,4817,2236,2581
454052,1043,宮崎県,児湯郡川南町,14930,7124,7806
454061,1199,宮崎県,児湯郡都農町,10148,4839,5309
454214,978,宮崎県,東臼杵郡門川町,17238,8244,8994
454290,1678,宮崎県,東臼杵郡諸塚村,1458,725,733
454303,1609,宮崎県,東臼杵郡椎葉村,2502,1277,1225
454311,1466,宮崎県,東臼杵郡美郷町,4677,2299,2378
454419,1162,宮崎県,西臼杵郡高千穂町,11038,5345,5693
454427,1541,宮崎県,西臼杵郡日之影町,3485,1671,1814
454435,1546,宮崎県,西臼杵郡五ヶ瀬町,3385,1667,1718
462012,28,鹿児島県,鹿児島市,595042,277453,317589
462039,281,鹿児島県,鹿屋市,99654,47748,51906
462047,930,鹿児島県,枕崎市,19235,8847,10388
462063,949,鹿児島県,阿久根市,18538,8780,9758
462080,508,鹿児島県,出水市,51783,24528,27255
462101,644,鹿児島県,指宿市,37920,17658,20262
462136,1065,鹿児島県,西之表市,14296,6912,7384
462144,1098,鹿児島県,垂水市,13258,6218,7040
462152,306,鹿児島県,薩摩川内市,91542,44506,47036
462161,562,鹿児島県,日置市,46642,22158,24484
462179,701,鹿児島県,曽於市,32948,15491,17457
462187,221,鹿児島県,霧島市,123979,60068,63911
462195,818,鹿児島県,いちき串木野市,26147,12383,13764
462209,726,鹿児島県,南さつま市,31720,14764,16956
462217,770,鹿児島県,志布志市,29193,13952,15241
462225,617,鹿児島県,奄美市,40965,19785,21180
462233,716,鹿児島県,南九州市,32079,15113,16966
462241,865,鹿児島県,伊佐市,23345,10907,12438
462250,348,鹿児島県,姶良市,78218,36810,41408
463035,1735,鹿児島県,鹿児島郡三島村,364,188,176
463043,1720,鹿児島県,鹿児島郡十島村,666,368,298
463922,932,鹿児島県,薩摩郡さつま町,19157,8975,10182
464040,1221,鹿児島県,出水郡長島町,9643,4688,4955
464520,1261,鹿児島県,姶良郡湧水町,8463,4000,4463
464686,1131,鹿児島県,曽於郡大崎町,12142,5820,6322
464821,1359,鹿児島県,肝属郡東串良町,6453,3058,3395
464902,1364,鹿児島県,肝属郡錦江町,6399,3070,3329
464911,1380,鹿児島県,肝属郡南大隅町,6163,2984,3179
464929,1077,鹿児島県,肝属郡肝付町,13944,6866,7078
465011,1309,鹿児島県,熊毛郡中種子町,7301,3509,3792
465020,1429,鹿児島県,熊毛郡南種子町,5288,2651,2637
465054,1144,鹿児島県,熊毛郡屋久島町,11591,5705,5886
465232,1680,鹿児島県,大島郡大和村,1413,710,703
465241,1665,鹿児島県,大島郡宇検村,1624,796,828
465259,1266,鹿児島県,大島郡瀬戸内町,8294,4119,4175
465275,1394,鹿児島県,大島郡龍郷町,5994,2885,3109
465291,1362,鹿児島県,大島郡喜界町,6410,3157,3253
465305,1205,鹿児島県,大島郡徳之島町,10067,5020,5047
465313,1418,鹿児島県,大島郡天城町,5544,2841,2703
465321,1374,鹿児島県,大島郡伊仙町,6202,3133,3069
465330,1381,鹿児島県,大島郡和泊町,6150,3078,3072
465348,1421,鹿児島県,大島郡知名町,5509,2783,2726
465356,1440,鹿児島県,大島郡与論町,5076,2481,2595
472018,78,沖縄県,那覇市,315485,152744,162741
472051,278,沖縄県,宜野湾市,100322,48754,51568
472077,517,沖縄県,石垣市,50191,25470,24721
472085,238,沖縄県,浦添市,115545,56048,59497
472093,423,沖縄県,名護市,64554,32176,32378
472107,428,沖縄県,糸満市,62607,31717,30890
472115,190,沖縄県,沖縄市,142283,69032,73251
472123,414,沖縄県,豊見城市,66101,32362,33739
472131,218,沖縄県,うるま市,126515,63455,63060
472140,479,沖縄県,宮古島市,55724,28276,27448
472158,565,沖縄県,南城市,46458,23423,23035
473014,1480,沖縄県,国頭郡国頭村,4512,2338,2174
473022,1568,沖縄県,国頭郡大宜味村,2987,1574,1413
473031,1660,沖縄県,国頭郡東村,1733,947,786
473065,1230,沖縄県,国頭郡今帰仁村,9286,4758,4528
473081,1105,沖縄県,国頭郡本部町,12970,6626,6344
473111,1156,沖縄県,国頭郡恩納村,11262,5806,5456
473138,1366,沖縄県,国頭郡宜野座村,6339,3204,3135
473146,1149,沖縄県,国頭郡金武町,11452,5731,5721
473154,1491,沖縄県,国頭郡伊江村,4295,2214,2081
473243,606,沖縄県,中頭郡読谷村,42060,20649,21411
473251,1103,沖縄県,中頭郡嘉手納町,13039,6333,6706
473260,772,沖縄県,中頭郡北谷町,29093,13859,15234
473278,963,沖縄県,中頭郡北中城村,17933,8638,9295
473286,875,沖縄県,中頭郡中城村,22616,11290,11326
473294,668,沖縄県,中頭郡西原町,35656,17992,17664
473481,918,沖縄県,島尻郡与那原町,19930,9703,10227
473502,618,沖縄県,島尻郡南風原町,40800,20009,20791
473537,1719,沖縄県,島尻郡渡嘉敷村,675,362,313
473545,1713,沖縄県,島尻郡座間味村,870,485,385
473553,1721,沖縄県,島尻郡粟国村,664,371,293
473561,1740,沖縄県,島尻郡渡名喜村,300,178,122
473570,1697,沖縄県,島尻郡南大東村,1224,717,507
473588,1728,沖縄県,島尻郡北大東村,557,337,220
473596,1699,沖縄県,島尻郡伊平屋村,1190,647,543
473600,1690,沖縄県,島尻郡伊是名村,1274,699,575
473618,1312,沖縄県,島尻郡久米島町,7279,3908,3371
473626,704,沖縄県,島尻郡八重瀬町,32881,16376,16505
473758,1703,沖縄県,宮古郡多良間村,1059,579,480
473812,1494,沖縄県,八重山郡竹富町,4249,2205,2044
473821,1662,沖縄県,八重山郡与那国町,1699,959,740
